Добрый день!	¡Buenos días!
- Как дела?<br>- Хорошо.	- ¿Qué tal?<br>- Bien.
- Вы куда?<br>- Я - домой.	- ¿Adónde va?<br>- Yo (voy) a casa.
- А вы - домой?<br>- Нет, в театр.	- Y Uds. ¿(van) a casa?<br>- No, al teatro.
- А в какой?<br>- Мы - в большой.	- ¿Y a cuál?<br>- Nosotros (vamos) al Bolshoi.
До свидания!	¡Hasta la vista!
Первый урок	Primera lección
Упражнения:<br>- Читайте и переводите.<br>- Восстановите текст.	Ejercicios:<br>- Lea y traduzca.<br>- Reconstruya el texto.
Второй урок	Segunda lección
- Алло! Алло! Это борис?<br>- Да, Это Я.	- ¡Oiga! ¡Oiga! ¿Es Boris?<br>- Sí, soy yo.
- А кто гаварит?<br>- Я, я говорю - Вадим.	- ¿Y quién habla?<br>- Soy yo ("yo, yo hablo"), Vadim.
- Здравствуй, друг!<br>- Здравствуй, брат!	- ¡Hola, amigo!<br>- ¡Hola, hermano!
- Как я рад!<br>- Я тоже рад!	- ¡Qué contento (estoy)!<br>- ¡Yo también estoy contento!
- Где ты?<br>- Дома.<br>- Приходи!	- ¿Dónde estás?<br>- En casa.<br>- ¡Ven!
Хорошо. До встречи!	De acuerdo. ¡Hasta pronto! ("hasta el encuentro")
Третий урок	Tercera lección
Простите, что вы говорите?	Perdone, ¿qué dice Ud.?
- Вы русский/русская?<br>- Нет, я испанец/испанка.	- ¿Es Ud. ruso/rusa?<br>- No, soy español/española.
- Вы хорошо говорите по-русски.<br>- Спасиво! Вы очень любезны.	- Habla Ud. bien el ruso.<br>- ¡Gracias! Es muy amable.
- А она говорит по-русски?<br>- Конечно! Она русская.	- ¿Y ella habla ruso?<br>- ¡Po supuesto! Es rusa.
- Давайте говорить по-русски!<br>- С удовольствем. Я очень лювлю русский язык.	- ¡Hablemos ruso!<br>- Con gusto. Me gusta mucho la lengua rusa.
Четвёртый урок	Cuarta lección
- Что ты делаешь?<br>- Учу английский язык.	- ¿Qué haces?<br>- Estudio inglés.
- Ты уже говоришь по-английски?<br>- Немного говорю, но всё понимаю.	- ¿Ya hablas inglés?<br>- Hablo un poco, pero lo entiendo todo.
- Ты знаешь французский язык?<br>- Конечно, знаю.	- ¿Sabes francés?<br>- Por supuesto, lo sé.
- А как по-французски "пока"?<br>- "Пока" по-французски "чао".	- ¿Y cómo (se dice) en francés "hasta luego"?<br>- "Hasta luego" en francés es "chao".
- Но это по-итальянски!<br>- Правда? Значит, я знаю и итальянский язык!	- ¡Pero eso está en italiano!<br>- ¿De verdad? (Eso) significa que también sé italiano.
- Всё ясно! До встречи!<br>- Пока!	- ¡Todo está claro! ¡Hasta pronto!<br>- ¡Hasta luego!
Пятый урок	Quinta lección
- Давайте познокомимся!<br>- С удовольствием!	- ¡Conozcámonos!<br>- Con (mucho) gusto.
- Мня зовут Давид. А как вас зовут?<br>- Мня зовут Наташа. Очень прятно.	- Me llamo Davik. ¿Cómo se llama Ud.?<br>- Me llamo Natasha, Mucho gusto.
- Какое красивое имя!<br>- Вы очень любезны.	- ¡Qué nombre tan bonito!<br>- Es Ud. muy amable.
Кстати, это мой русский друг. Его зовут Вадим.	A propósito, este es mi amigo ruso. Se llama Vadim.
- А я его знаю!<br>- Конечно! Он очень известный актёр.	- ¡Pero yo lo conozco!<br>- ¡Por supuesto! Es un actor muy famoso.
- А вот моя подруга. Вы её знаете?<br>- Нет, я её не знаю. к сожалению.	- Y esta es mi amiga. ¿La conoce?<br>- No, no la conozco, por desgracia.
Какая красивая девушка!	¡Qué chica tan bonia!
Шестой урок	Sexta lección
- Скажите, кто это?<br>- Это мой брат.	- Díga(me), ¿quién es este?<br>- Este es mi hermano.
- Правда!? А кто он?<br>- Он актёр.	- ¿De verdad? ¿Y qué hace? ("quién es").<br>- Es actor.
- Вы тоже работаете в театр?<br>- Да, я тоже работаю в театре, но я режиссёр.	- ¿Ud. también trabaja en el teatro?<br>- Sí, yo también trabajo en el teatro, pero yo soy director.
Как интересно! Я очень люблю театр.	¡Qué interesante! Me gusta mucho el teatro.
- А вы где работаете?<br>- Я журналистка и работаю в газете.	- ¿Y Ud. dónde trabaja?<br>- Yo soy periodista y trabajo en el periódico.
- А где вы живёте?<br>- Я живу в Москве.<br>- А я живу в Киеве.	- ¿Y dónde vive Ud.?<br>- Yo vivo en Moscú.<br>- Y yo vivo en Kiev.
- А где живёт ваш брат?<br>- Он живёт в Одессе.	- ¿Y dónde vive su hermano?<br>- Vive en Odesa.
О! Это очень красивый город!	¡Oh! Es una ciudad muy bonita.
- Я вас приглашаю в театр.<br>- А в какой?<br>- В Большой.	- La invito al teatro.<br>- Y ¿a cuál?<br>- Al Bolshoi.
- Какая прекрасная фотография!<br>- Это моя семья.	- ¡Qué bonita fotografía!<br>- Es mi familia.
- А это, конечно же, ваша мама? какая молодая и прекрасная женщина!<br>- Да, все так говорят.	- ¿Y esta, seguramente, es su madre? ¡Qué mujer tan joven y bonita!<br>- Sí, todos lo dicen.
- У вас её лицо, её фигура...<br>- Спасебо за комплимент!	- Tiene Ud. su cara, su tipo.<br>- Gracias por el piropo.
- А вот мой отец. Правда, интересный мужчина?<br>- Очень!	- Y este es mi padre. Es un hombre atractivo, ¿verdad?<br>- ¡Mucho!
 - Кстати, у вас есть сестра?<br>- Да, у меня есть сестра и брат.	- Por cierto, ¿Tiene Ud. hermana(s)?<br>- Sí, tengo una hermana y un hermano.
- Ваша сестра замужем?<br>- Да, замужем. Вот её дочь. А брат хенат. Вот его хена, а это их сын.	- ¿Su hermana está casada?<br>- Sí, está casada. Esta es su hija. Y mi hermano está casado. Esta es su esposa, y este el hijo de ellos.
- Чудесные дети.<br>- Да, я их очень люблю.	- Unos niños encantadores.<br>- Sí, yo los quiero mucho.
Семейная фотография	Fotografía familiar
Седьмой урок	Séptima lección
Восьмой урок	Octava lección
Девятый урок	Novena lección
Ты знаешь, мой брат женится	¿Sabes? Mi hermano se casa
- Вот это сюрприз! А кто его невеста?<br>- Ты её знаешь, но попробуй угадать.	- ¡Qué sorpresa! ¿Y quién es su novia?<br>- Tú la conoces, pero intenta adivinarlo.
- Я думаю, это не легко, но я попробую. Какие у неё глаза?<br>- У неё синие глаза.	- Creo que no es fácil pero lo intentaré. ¿Cómo son sus ojos?<br>- Tiene los ojos azules.
- ... и чёрные волосы?<br>- Нет, нет! Она блондинка.	- ... ¿y los cabellos negros?<br>- ¡No, no! Es rubia.
- Она высокая как ты?<br>- Нет, наоборот - она маленькая, но у неё прескасная фигура.	- ¿Es alta, como tú?<br>- No, al contrario, es pequeña pero tiene un tipo precioso.
- Кашется, я её видела у тебя. Её зовут Катя.<br>- Правильно! Катя Иванова. Она тебе нравится?	- Me parece que la vi en tu casa. Se llama Katya.<br>- ¡Así es! Katya Ivanova. ¿Te gusta?
- Главное, что ему нравится.<br>- Как говорят: "На вкус, на цвет, товарищей нет".	- Lo principal es que le guste a él.<br>- Como dicen: "sobre gustos y colores no hay nada escrito" ("no hay compañeros").
Да, это абсолютно верно.	Sí, eso es absolutamente cierto.
- Вадим, привет! Это Лена!<br>- А, Леночка, рад тебя слышать.	- ¡Hola, Vadim! ¡Soy Lena!<br>- A, Lenochka, me alegra oírte.
- Где ты утром? Всё утро я тебе знонила...<br>- Утром я был в университете.	- ¿Dónde estabas por la mañana? Te he estado llamando toda la mañana.<br>- Por la mañana estaba en la universidad.
- Я тебе знонила днём, но убы...<br>- А потом я работал в библиотеке.	- Te llamé por la tarde, pero nada ("¡ay!") ...<br>- Es que después estuve trabajando en la biblioteca.<br>
- Какой ты молодец! А я ничего не делаю. Мне стыдно!<br>- Ну, что ты! У теба каникулы.	- ¡Qué buen chico! Yo, en cambio, no hago nada. ¡Me da vergüenza!<br>- Pero, ¿qué dices? Tienes vacaciones.
- У меня вопрос. Ты вечером свободен?<br>- Конечно! А ты свободна?	- Tengo una pregunta. ¿Estás libre esta noche?<br>- ¡Por supuesto! ¿Y tú estás libre?
- Как птица. И мы идём в кино.<br>- Прескрасная идеа. С удовольствием.	- Como un pájaro, ¿Vamos al cine?<br>- ¡Muy buena idea! Con mucho gusto.
- До встречи у меня.<br>- До скорой встречи. Целую.<br>- Я тебя тоже целую. Пока.	- Nos vemos en mi casa ("hasta el encuentro en mi casa").<br>- Hasta pronto. Un beso.<br>- Un beso también para ti. Hasta luego.
- Ты не работаешь?<br>- Нет, у меня отпуск. 	- ¿No trabajas?<br>- No, tengo vacaciones.
- Добрый вечер, Вадим. Что ты здесь делаешь?<br>- Так, ничего. Гуляю.	- Buenas tardes, Vadim. ¿Qué haces?<br>- Pues nada. Paseo.
О! Какие розы! Мне всё понятно	¡Oh! ¡Qué cosas! Ya lo entiendo todo
- А ты куда идёшь?<br>- У меня свидание, но деловое.	- ¿Y tú adónde vas?<br>- Tengo una cita, pero de trabajo.
- А вот Лена. Позкомьтесь, пожалуйста. Это Игорь.<br>- Лена. Мне очень приятно.	- Ya está aquí Lena. Os presento ("conózcanse, por favor"). Este es Igor.<br>- Lena. Mucho gusto.
Извините, я должен идти.<br>	Perdonad, me tengo que ir.
- А может быть, пойдём в кино.<br>- Спасибо, Вадим. Но у меня Дела. Да и третий лишний.	- Podríamos ir al cine.<br>- Gracias, Vadim, pero tengo que hacer. Además, el tercero sobra.
- Вадим, прости, но мы должны идти.<br>- Идём, идём, Леночка.	- Vadim, perdona pero tenemos que irnos.<br>- Ya vamos, ya vamos, Lenochka. 
- Почему вы такой грустный?<br>- Как вам сказать? Я лишний в моём доме...	- ¿Por qué está tan triste?<br>- ¿Cómo decirle? Sobro en mi casa.
- Не может быть! У вас такая прекрасная семья...<br>- Да, но дело в том, что в моей семье все учатся.	- ¡No puede ser! Tiene Ud. una familia tan encantadora...<br>- Sí, pero el caso es que en mi familia todos estudian.
- Но это же прекасно!<br>- Да, но моя жена учится играть на пианино, дочь весь день играет на скрике, а сын всё время играет на гитаре.	- ¡Pero eso es magnífico!<br>- Sí, por mi mujer aprende a tocar el piano, mi hija toca todo el día el violín y mi hijo toca todo el tiempo la guitarra.
- А что вы делаете в это время?<br>- Я слушаю и страдаю.	- ¿Y qué hace Ud. durante ese tiempo?<br>- Escucho y sufro.
- А почему вы сами не учитесь играть?<br>- Простите, но на чём?<br>- Например, на барабане.	- ¿Y por qué no aprende Ud. mismo a tocar?<br>- Perdone, ¿pero qué?<br>- Por ejemplo, el tambor.
- Я буду им мешать.<br>- Играйте ночью.<br>- Спасибо за совет!	- Los molestaré.<br>- Toque de noche.<br>- ¡Gracias por el consejo!
- Ты пойдёшь в нами гулять?<br>- К сожалению, нет. Мне некогда.	- ¿Vienes con nosotros a pasear?<br>- Por desgracia, no. No tengo tiempo.
- А вечером мы пойдём в театр. Хочешь с нами?<br>- Чочу, но мне никогда.	- Y por la noche iremos al teatro. ¿Quieres venir con nosotros?<br>- Quiero, pero no tengo tiempo.
- А что ты будешь делать вечером?<br>- Вечером я буду работать.	- ¿Y qué vas a hacer por la noche?<br>- Por la noche voy a trabajar.
- Какой ты молодец! Ты весь день работаешь.<br>- Да, утром, днём и вечером я учу русский язык.	- ¡Qué buen chico eres! Trabajas todo el día.<br>- Sí, por la mañana la tarde y la noche estudio ruso.
- Ты едешь в Москву?<br>- Нет, Я еду скоро в Санкт-Петерсбург.	- ¿Vas a Moscú?<br>- No, voy pronto a San Petersburgo.
- А ты будешь там говорить по-русски?<br>- Конечно; русские говорят: "без труда не вынешь рыбку из пруда".	- ¿Y allí hablarás ruso?<br>- Por supuesto; los rusos dicen: "sin trabajo no sacas el pez del estanque".
Успехов тебе!	¡Que tengas éxito!
Я еду в театр на такси а он идёт пешком.	Yo voy al teatro en taxi y él va a pie.
- Здравстбуй, Вадим. Как настроение?<br>- Настроение прекрасное. У меня было свидание.	- Hola, Vadim. ¿Cómo está el ánimo?<br>- El ánimo bien. He tenido una cita.
- Поздравлаяю! У теба всё хорошо?<br>- Да, да, почти всё хорошо.	- ¡Te felicito! ¿Todo te va bien?<br>- Sí, sí, casi todo va bien.
- Прости, как это понимать?<br>- Всё было хорошо напоповину: я пришёл, а она - нет.	- Perdona ¿Qué quieres decir con eso?<br>- Todo ha ido bien a medias: you fui, pero ella no.
- А у меня настроение плохое.<br>- Как так? Ты ведь недавно женился.<br>- Вот именно! Но я всё время думаю, что ей повезло больше, чем мне.	- Yo, en cambio, estoy de mal humor.<br>- ¿Cómo es eso? Si acabas de casarte.<br>- ¡Por eso precisamente! Todo el rato pienso que ella tiene más suerte que yo.
- Куда вы идёте после работы?<br>- Я сразу же еду на машине домой.	- ¿Adónde va después del trabajo?<br>- Voy enseguida a casa en coche.
- А чем вы занимаетесь дома?<br>- О! Дома у меня всегда много работы.	- ¿Y qué hace ("en qué se ocupa") Ud. en casa?<br>- Oh, en casa siempre tengo mucho trabajo.
- А что вы будете делать сегодна?<br>- Сегодня я буду готовить.	- ¿Y qué va a hacer hoy?<br>- Hoy voy a cocinar.
- Вы умеете готовить?<br>- Не только умею, но очень люблю.	- ¿Ud. sabe cocinar?<br>- No solo sé, sino que me gusta mucho.
- А что вы готовите овычно на первое?<br>- Всё, что хотите: борщ, суп, щи.	- Y generalmente ¿qué cocina de primero?<br>- Lo que Ud. quiera: borsch, sopa, schi.
- А но второе?<br>- Котлеты, пельмени и прочее.	- ¿Y de segundo?<br>- Croquetas, pelmeñi, etc. ("y parecidos")
- И какое её блюдо вам нравится больше всего?<br>- Бутерброды.	- ¿Y qué plato le gusta más?<br>- Los bocadillos.
(Желаю вам) приятного аппетита	(Le deseo) buen provecho ("apetito")
- Друзья! Пора за стол.<br>- С удовольствием. Я проголодался.	- ¡A la mesa compañeros!<br>- Con mucho gusto. Me ha entrado hambre.
- Что вы будете есть?<br>- Всё, что вы предложите.	- ¿Qué va Ud. a comer?<br>- Todo lo que recomienden.
- Что вы будете пить? Водку, вино...<br>- И пиво  тоже.	- ¿Qué van a beber? Vodka, vino, ...<br>- Y también cerveza.
- К сожалению, у нас нет пива.<br>- Это неважно. Дайте, пожалуйста, немного воды.	- Por desgracia, no tenemos cerveza.<br>- No importa. Denme, por favor, un poco de agua.
- У нас сколько угодно воды.<br>- Ни и отлично! Вы прескрасно готовите.	- Tenemos cuanta agua quiera.<br>- ¡Eso es excelente! Cocinan Uds. muy bien.
- Хотите немного салата?<br>- Салата я не хочу, а вот грибы попробую.	- ¿Quiere un poco de ensalada?<br>- No quiero ensalada, pero voy a probar estos champiñones.
- Я пью за ваше здоровье.<br>- За нашу встречу.	- Bebo a su salud.<br>- Por nuestro encuentro.
- Аня, Что ты говоришь маме утром?<br>- Утром маме, папе и брату я гоборю: "Доброе утро".	- Anya, ¿qué le dices a mamá por la mañana?<br>- Por la mañana digo "¡Buenos días!" a mamá, a papá y a mi hermano.
- А что ты говоришь днём?<br>- Днём Я говорю: "Доврый день!"	- ¿Y qué les dices durante el día?<br>- Durante el día les digo "¡Buenos días!"
- А вечером?<br>- Вечером я говорю: "Добрый вечер"	- ¿Y por la tarde?<br>- Por la tarde digo "¡Buenas tardes!"
- А что ты говоришь маме, когда ложишься спать?<br>- Когда ложусь спать, я говорю: "Спокойной ночи!"	- ¿Y qué le dices a mamá cuando vas ("te acuestas") a dormir?<br>- Cuando voy a dormir digo: "¡Buenas ("tranquila") noches!"
- Какая ты умница! А что ты скажешь бабушке, есле она даст тебе конфеты?<br>- Я скажу ей: "Дай, пожалуйста, ещё".	- ¡Qué inteligente eres! ¿Y qué vas a decir a la abuela, si te da un caramelo?<br>- Le diré: "Dame más, por favor".
- Аня, ты шутишь?<br>- Конечно, я шучу. Я ей скажу: "Большое спасибо!"	- Anya, ¿bromeas?<br>- Naturalmente, bromeo. Le diré: "¡Muchas gracias!"
- Ты очень хорошая девочка!<br>- Да, это мне все говорят.	- ¡Eres una niña muy buena!<br>- Sí, lo dice todo el mundo.
- Сегодня чудесная погода!<br>- Не знаю, не знаю. Утром было прохладно.	- ¡Hoy hace un tiempo maravilloso!<br>- No sé, nosé. Por la mañana hizo frío.
- Но сейчас на улице телло.<br>- Да, но идёт дождь.	- Pero ahora hace calor en la calle.<br>- Sí, pero llueve.
- Это не страшно. У меня есть прекрасный зонт.<br>- О, зонт, на самом деле, прекрасный. Где вы его купили?	- No es tan terrible. Yo tengo un paraguas precioso.<br>- Oh, el paraguas es, efectivamente, precioso. ¿Dónde lo compró?
- Это подарок. Мне его подарила хена.<br>- Ах, да, я завыла. Вчера у вас был день рождения.	- Es un regalo. Me lo regaló mi mujer.<br>- Ah, sí, lo olvidé. Ayer fue su cumpleaños.
- Да, годы идут!<br>- А сколько вам лет, если не секрет?	- ¡Sí, los años pasan!<br>- ¿Y cuántos años tiene Ud., si no es un secreto?
- Какой там секрет? Мне уже сорок один год.<br>- Да вы ещё юноша!	- ¿Qué secreto? Ya tengo cuarenta y un años.<br>- ¡S es Ud. un mozo todavía!
- Как дела у вашей дочери?<br>- Прекрасно! Она недавно вышла замуж.	- ¿Cómo se va a su hija?<br>- Muy bien. Hace poco se casó.
- Поздравляю! И за кого?<br>- За очень прекрасного молодого человека.	- ¡Felicidades! ¿Y con quién?<br>- Con un joven muy excelente.
- У неё всё хорошо?<br>- Просто замечательно. Он помогает ей готовить, стирать, мыть посуду и ходит в магазин.	- ¿Todo le va bien?<br>- Simplemente fenomenal. Él la ayuda a cocinar, a lavar, a fregar los platos ("la vajilla") y va de compras ("a la tienda").
- Да, ей действительно повезло. А как дела у вашего сына?<br>- Нечего хорошего.	- Sí, ella efectivamente ha tenido suerte. ¿Y cómo le va a su hijo?<br>- Nada bien.
- Да!? А в чём дело?<br>- Ему не повезло. Бедный наш мальчик должен сам всё готовить, стирать, мыть посуду и ходить в магазин.	- ¿Sí? ¿Qué le pasa?<br>- No ha tenido suerte. Nuestro pobre hijo tiene que cocinar, lavar, fregar los platos e ir de compras él mismo.
- У меня есть предложение: давайте перед ужином немного погуляем.<br>- С большим удовольствием! А куда мы пойдём?	- Tengo una propuesta: antes de cenar demos un paseíto.<br>- Con mucho gusto. ¿Y adónde iremos?
- Сначала мы пройдём по Тверской до Пушкинской площади.<br>- Я давно хотел посмотреть памятник Пушкину.	- Primero pasaremos por la calle del Tver hasta la plaza Pushkin.<br>- Hace tiempo que quería ver el monumento de Pushkin.
- Вот и прикрасно! Потом погуляем по Тверскому бульвару.<br>- Говорят, там очень красиво.<br>- Да, это моё любимое место в Москве.	- ¡Magnífico! Después pasearemos por el paseo de Tver.<br>- Dicen que es muy bonito.<br>- Sí, es mi lugar preferido en Moscú.
- А на Арбат мы пойдём?<br>- Конечно, это в двух шагах.	- ¿Vamos a ir también al Arbat?<br>- Por supuesto, está a dos pasos.
- Я давно хотел пойти туда. Там можно купить чудесные сувениры.<br>- Купим сувениры, а заодно и где-нибудь поужинаем.<br>- Прекрасный план! Я готов. Идём.	- Hace mucho que quería ir allá. Pueden comprarse unos regalos maravillosos.<br>- Compraremos regalos, y de paso cenaremos en algún sitio.<br>- ¡Espléndido plan! Estoy listo. Vamos.
- Скажите, пожалуйста, как попасть на Арбат?<br>- О, это очень просто. Если вы спешите, садитесь на троллейбус.	- Dígame, por favor, ¿cómo ir al Arbat?<br>- Oh, es muy fácil. Si tiene prisa, tome el trolebús.
- А где здесь остановка?<br>- В двух шалах, за улгом аптеки.	- ¿Y dónde hay por aquí una parada?<br>- A dos pasos, a la esquina de la farmacia.
- А если я пойду пешком?<br>- Это совсем недалеко. Идите по бульвару прямо.	- ¿Y si voy a pie?<br>- No está nada lejos. Vaya derecho por la avenida.
- Я боюсь заблудиться.<br>- Ну, что вы! Вы прекрасно говорите по-русски, а язык до Киева доведёт.	- Tengo miedo de perderme.<br>- Bueno, ¡qué dice! Ud. habla muy bien el ruso, y "la lengua lleva hasta Kiev".
- Но доведёт ли он меня до Арбата?<br>- Я вас провожу.	- Pero ¿me llevará hasta el Arbat?<br>- Yo lo acompaño.
- Вы очень любезны! Спасибо вам!<br>- Ну, что вы! Это пустяки!	- Es Ud. muy amable. Gracias.<br>- No hay de qué. No es nada.
- Мы почти пришли. Вы не устали?<br>- Нет, нет, я совсем не устал. Такая приятная прогулка!	- Casi hemos llegado. ¿No está Ud. cansado?<br>- No, no, no estoy cansado en absoluto. ¡Qué paseo tan agradable!
- А что это за здание?<br>- Слева театр Маяковского. А справа обратите внимание, прекрасная церковь.	- ¿Y qué edificio es ese?<br>- A la izquierda está el teatro de Mayakovski. A la derecha, fíjese Ud. una iglesia preciosa.
- Давайте подойдём к ней. Какая красота!<br>- В этой церкви венчался Пушкин. Да и жил он недалеко отсюда.	- Acerquémonos a ella. ¡Qué hermosura!<br>- En esta iglesia se casó Pushkin. Y también vivió cerca de aquí.
- Простите, не буду вас больше задерживать.<br>- А я некуда не спешу. По утрам я репетиурю, по вечерам играю в оркестре, я днём гуляю.	- Perdone, no lo entretendré más.<br>- Si yo no tengo prisa. Por las mañanas ensayo, por las noches toco en una orquesta, y de día paseo.
- Мне повезло, что я познакомился с вами.<br>- Мне тоже очень приятно показать вам Москву.	- He tenido suerte en encontrarme con Ud.<br>- A mí también me gusta mucho enseñarle Moscú.
- Сколько дней вы будете в Москве?<br>- Ровно семь дней.	- ¿Cuántos días estará en Moscú?<br>- Siete días justos.
- Неделю? Это прекрасно. Есть время и поработать и посмотреть город.<br>- К сожалению, времени у меня не так много.	- ¿Una semana? Es estupendo. Hay tiempo para trabajar como para ver la ciudad.<br>- Por desgracia, no tengo tanto tiempo.
- А какие у вас планы?<br>- В понедельник у меня встреча в университете. Во вторик я делаю доклад.	- ¿Y qué planes tiene Ud.?<br>- El lunes tengo una cita en la universidad. El martes doy una conferencia.
- А среда, мне кажется, у вас свободный день?<br>- В среду я свободен, а в четверг я вуду на конференции.	- Pero el miércoles me parece que está libre, ¿no?<br>- El miércoles estoy libre, el jueves, en cambio doy una conferencia.
- А в пятницу я могу вас пригласить в гости?<br>- С удовольствием! Только вечером.	- Pero el viernes ¿puedo invitarlo a mi casa?<br>- Con mucho gusto. Pero solo por la tarde.
- Не забывайте, в субботу мы едем в Суздаль.<br>- А в воскресенье я уезжаю в Санкт-Петерсбург.	- No olvide que el sábado vamos a Susdal.<br>- Y yo el domingo me voy a San Petersburgo.
Но в любом слугае мы найдём время посмотреть Москву.	En todo caso hallaremos tiempo para ver Moscú.
- Сто лет мы с вами знакомы, а вы у меня никогда не были.<br>- Да, знаете, всё дела, дела.	- Hace mil ("cien") años que nos conocemos, y Ud. no ha venido nunca a mi casa.<br>- Sí, ya sabe Ud., siempre trabajo, trabajo.
- Русские говорят: все дела не переделаешь. Оставьте всё и приходите к нам вечером.<br>- Как? Прямо сегодна вечером?	- Los rusos dicen: no llegarás jamás a arreglar todas las cosas. Déjelo Ud. todo y venga a vernos esta noche.<br>- ¿Cómo? ¿Esta misma noche?
- А что здесь такого?  Приходите запросто. Хена будет рада.<br>- Боюсь, ей не до меня. Она так много работает.	- ¿Y eso qué tiene de especial? Venga con toda naturalidad. Mi mujer estará contenta.<br>- Me temo que no tendrá tiempo para mí. ¡Trabaja tanto!
- Ничего, ничего. Завтра выходной.<br>- А потом, я знаю вас русских: вудете бегать по магазинам, готовить.	- Nada, nada. Mañana es día libre.<br>Además, conozco a Uds., los rusos: van a ir de compras y luego se ponen a cocinar.
- У нас всё готово. Чем богаты, тем и рады.<br>- Последнюю фразу я не поняла.	- Lo tenemos todo preparado. Cuan ricos, tan contentos.<br>- No he entendido la última frase.
- Так русские говорят, когда хотят сказать, что будет всё просто, по-семейному.<br>- Согласна. А какой ваш адрес?	- Eso dicen los rusos cuando quieren decir que todo será sencillo, familiar.<br>- De acuerdo. ¿Y cuál es su dirección?
- Вот и хорошо. Пишите: улица Волгина, дом 6, квартира 14. А лучше я вас встречу у метро "Беляево".<br>- Я буду ровно в семь.	- Bueno. Escriba Ud.: calle Volguina, edificio 6, piso 14. Pero mejor la espero en la boca de metro "Beliaevo".<br>- Estaré allí a las siete en punto.
- Ровно или чуть-чуть опоздаете?<br>- Нет, нет, я буду мниута в минуту.	- ¿En punto o se retrasa un poco?<br>- No, no, estaré a la hora exacta.
- Мне кажется, вы хили раньше в центре Москвы?<br>- Да, недалеко от Пушкинской площади. Но два года назад мы переехали.	- Me parece que Uds. vivían antes en el centro de Moscú, ¿no?<br>- Sí, cerca de la Plaza de Pushkin. Pero nos trasladamos hace dos años.
- У вас новая квартира?<br>- Да, мы купили квартиру в новом районе, а старую оставили сыну.	- ¿Tienen un piso nuevo?<br>- Sí, compramos un piso en el barrio nuevo, y el antiguo se lo dejamos a nuestro hijo.
- И вам нравится этот новый район?<br>- Конечно, работа рядом, лес в двух шагах, а главное, квартира отличная.	- ¿Y les gusta el barrio nuevo?<br>- Desde luego, el trabajo está al lado, el bosque a dos pasos y, lo más importante, el piso es espléndido.
- А сколько у вас комнат?<br>- Три: столовая, спальна, мой маленький кавинет и вольшая кухня. Нам с женой вполне достаточно.	- ¿Y cuántas habitaciones tienen?<br>- Tres: el comedor, el dormitorio, mi pequeño despacho y una cocina grande. Para mí y mi mujer totalmente suficiente.
- А на каком етаже вы живёте?<br>- На шестом, но я, предьставте поднимаюсь без лифта. Надо быть в форме.	- ¿Y en qué piso viven?<br>- En el sexto, pero figúrese que subo sin ascensor. Hay que estar en forma.
- Кстати, я тоже недавно переехал. Теперь у меня маленькый дом под Парижем.<br>- О! Собьственный дом за городом, моя мечта...	- Por cierto, hace poco yo también me he trasladado. Ahora tengo una casita en los alrededores de París ("bajo París").<br>- ¡Oh! Una casa propia en los alrededores de la ciudad, mi sueño...
- И моя тоже. Я счастлив, что она сбылась.<br>- Я вас поздравлаю.	- Y el mío también. Estoy feliz de que se haya hecho realidad.<br>- Le felicito.
- Дорогая, а что мне надеть?<br>- Надень серый костюм и голубую рубашку.	- Querida, ¿qué me pongo?<br>- Ponte el traje gris y la camisa azul.
- Помоги мне, пожалуйста, выбрать галстук.<br>- Надень вот етот синий в полоску.	- Ayúdame, por favor, a elegir una corbata.<br>- Ponte la azul de rayas.
- А может, этот красный в горошек.<br>- Но он сюда совершенно не идёт.	- O quizá esta roja con lunares.<br>- ¡Pero si esa no pega en absoluto!
- Ты так думаешь? А впрочем, ты, как всегда, правда.<br>- Кстати, туфли возьми чёрные, а не эти коричневые.<br>- Как ты скажешь, дорогая.	- ¿Tú crees? Por otro lado, tienes razón, como siempre.<br>- A propósito, ponte ("coge") los zapatos negros, y no esos marrones.<br>- Como digas, querida.
- Между прочим, в этом году летом будут носить рубашки без пуговиц.<br>- О! Значит, я уже почти десять лет одеваюсь по моде.	- Por cierto, este verano las camisas se llevarán sin botones.<br>- ¡Oh! Eso significa que ya hace diez años que me visto a la moda.
- Вот я и готова. Посмотри на меня.<br>- Ты просто великолепна! Как всегда.	- Bueno, ya estoy lista. Mírame.<br>- ¡Estás simplemente guapísima! Como siempre.
- Почему ты такой грыстный?<br>- Я не грустный, а озбоченный.	- ¿Por qué estás tan triste?<br>- No estoy triste, sino preocupado.
- Что? Есть проблемы?<br>- К счастью, нет, но скоро праздники...	- ¿Qué pasa? ¿Hay problemas?<br>- Por suerte, no, pero pronto serán las fiestas.
- Так это же хорошо, отдохнём.<br>- Да, но подарки! Ты же знаешь, какая у меня семья! Вот и ломаю голову кому что купить.	- Si eso es bueno, descansaremos.<br>- Sí, pero ¡los regalos! No sabes qué familia tengo. Pues ahora estoy rompiéndome la cabeza pensando qué comprar a quién.
- А я ету проблему решли просто.<br>- Прости, а каким образом?	- Yo resolví ese problema muy fácilmente.<br>- Perdona, pero ¿de qué manera?
- Я купил хене очень дорогую посуду.<br>- А почему очень дорогую?	- Le compré a mi mujer una vajilla muy cara.<br>- Pero ¿por qué muy cara?
- А теперь она больше не будет меня заставлять мыть посуду.<br>- А между прочим, не купить ли мне самый дорогой сервиз?	- Es que a partir de ahora ("más") ya no me va a obligar a fregar los platos.<br>- Es verdad, ¿por qué no le compro yo el servicio de mesa más caro?
- Прикрасная идея! Вот видишь, как всё просто решается.<br>- Недаром говорят, один ум хорошо, а два лучше.	- ¡Muy buena idea! Ya ves lo fácilmente que se resuelve todo.<br>- No sin razón dicen que dos cabezas son mejor que una.
- У вас нет таблетки от головы?<br>- Вот, пожалуйста, аспирин. А что случилось?	- ¿No tendrá pastillas para (el dolor de) cabeza?<br>- Tenga una aspirina. Pero ¿qué le ha pasado?
- Наверное, я очень устала, поздно легла, плохо спала.<br>- Может быть, у вас температура? Ну, конечно же, лоб горячий и совсем больные глаза.	- Posiblemente estoy muy cansada, me he acostado tarde, he dormido mal.<br>- Puede ser. Desde luego, tiene la frente ardiente y los ojos totalmente enfermos.
- Наверное, я простудилась.<br>- Вам нужно срочно обратиться к врагу.	- Posiblemente me he resfriado.<br>- Tiene que ver al médico sin demora.
- Нет, лучше я пойду домой, посплю, отдохну, а завтра буду как огурчик.<br>- А может, вам дать адрес хорошего врача? Он вылечил мою хену за несколько минут.	- No, mejor iré a casa, dormiré un buen rato y mañana estaré como nueva ("como un pepinillo").<br>- ¿Quiere que le dé la dirección de un buen médico? Curó a mi mujer en pocos minutos.
- Да? Каким образом?<br>- Он сказал ей, что её болезни - ето симптом старости.	- ¿Sí? ¿De qué manera?<br>- Le dijo que sus enfermedades eran síntoma de vejez.
- Ах! Вы всегда шутите. А впрочем, мне стало лучше.<br>- Вот видите, смех лечит все болезни.	- ¡Ah! Ud. siempre bromea. Pero por otra parte, comienzo a sentirme mejor.<br>- Ya ve, la risa cura todas las enfermedades.
- Чем вы занимаетесь в свободчое бремя?<br>- К сожаленю, в последнее время у меня нет минуты свободного времени. А вы?	- ¿A qué se dedica en su tiempo libre?<br>- Por desgracia, últimamente no tengo ni un minuto libre. ¿Y Ud.?
- Я увлекаюсь спортом и музыкой. Музыка - моя слабость.<br>- А я уже сто лет не был в театре. Каждый вечер работаю над докладом.	- Yo me dedico al deporte y a la música. La música es mi debilidad.<br>- Pues yo hace un siglo que no he ido al teatro. Todas las noches trabajo en mi tesis.
- И конечно же, плохо засыпаете?<br>- Нет, засыпаю нормально, у меня есть прекрасное средство.	- Y, claro está, duerme mal.<br>- No, duermo normal, tengo un método eficaz.
- Наверное, вы перед сном гуляете?<br>- Нет, что вы! Мне некогда, да и лень выходить на улицу.	- ¿Tal vez pasea antes de dormir?<br>- No, qué va. No tengo tiempo, además me da pereza salir a la calle.
- Неужели вы пьёете снотворное?<br>- Не в коем случае! Я перед сном читаю свой доклад.	- Pero no toma somníferos, ¿verdad?<br>- De ninguna manera! Antes de dormir leo mi tesis.
- Как вы севя чувствуете?<br>- Как вам сказать, доктор, в лоследнее время, не очень.	- ¿Cómo se siente Ud.?<br>- Cómo decirle, doctor, últimamente no muy bien.
- А что вас беспокоит?<br>- Усталость по вечерам и слабость по утрам.	- ¿Y qué le preocupa?<br>- El cansancio por las noches y la debilidad por las mañana.
- Вы много работаете?<br>- Как всегда, иногда много, иногда не очень.	- ¿Trabaja Ud. mucho?<br>- Como siempre, a veces mucho, otras no tanto.
- Вы курите? Пьёте?<br>- Нет, не курю, недавно бросил. А пью только по праздикам.	- ¿Ud. fuma? ¿Bebe?<br>- No, no fumo, hace poco lo he dejado. Y solo bebo los días de fiesta.
- Вы занимаетесь спортом?<br>- Бегаю по субботам, а по воскресеньям хожу в бассейн.	- ¿Practica algún deporte?<br>- Corro los sábados y los domingos voy a la piscina.
- Сердце вас не беспокоит?<br>- Нет, слава Богу.	- ¿No le molesta el corazón?<br>- No, gracias a Dios.
- Пульс у вас нормальный, давление нормальное. С таким здоровьем будете жить сто лет!<br>- Доктор, скажите, что же со мной случилось? В прошлый раз вы говорили, что я проживу сто двадцать лет.	- Tiene Ud. el puls normal, la tensión normal. Con una salud así vivirá cien años.<br>- Doctor, dígame, ¿qué me ha pasado? La última vez dijo que viviría ciento veinte años.
Вы когда-нибудь Бывали<br>В городе Спасибоград,<br>Где на Вежливом бульваре<br>Вежливо благодарят?	¿Ha estado alguan vez <br>En la "Ciudad de las Gracias"<br>Donde en el paseo de la Cortesía<br>Le dan las gracias con cortesía?
В переулке Гостевом<br>Зазывают в каждый дом,<br>Даже если вас не знают,<br>И никто вам не знаком!	En la calle de los Huéspedes<br>No cansan de invitarle a cada casa<br>Incluso si no le conocen<br>Y Ud. tampoco conoce a nadie
На проспекте угощения<br>Вас на славу угостят	En la avenida del convite<br>Le convidan (que da) gloria
Что вы любите? Варенье?<br>Эскимо? Халву? Печенье?<br>Или, может, лимонад?	¿Qué gusta Ud.? ¿Mermelada?<br>¿Un esquimal (helado)? ¿Una jalva? ¿Galletas?<br>¿O, quizás, limonada?
В єтом городе кругом<br>Люди говорят друг другу<br>Незнакомому и другу<br>И особенно гостям:<br>"Очень рады, рады вам!"	En esta ciudad por todas partes<br>Las gentes se dicen unos a otros<br>al desconocido y al amigo<br>y sobre todo a los huéspedes:<br>"¡Estamos muy, muy contentos de tenerlo aquí!"
- Разешите представиться, Роберт Вагнер, представитель фирмы "Рапидэко". Мне нужен господин Потапов.<br>- С приездом, господин Вагнер! Мы вас ждём.	- Permítame que me presente: Robert Wagner, representante de la empresa "Rapideco". ¿Podría hablar con el Sr. Potapov?<br>- Bienvenido, Sr. Wagner. Le esperábamos.
- Господин Потапов сейчас на месте?<br>- Извините, у него совещание у директора. Он просил вас подождатъ.	- ¿Está [en el sitio] el Sr. Potavov?<br>- Disculpe, tiene una reunión con el director. Le pide que espere un poco.
- К сожалению, у меня очень мало времени.<br>- Он будет с минуты на минуту.	- Por desgracia, tengo muy poco tiempo.<br>- Estará aquí de un momento a otro.
- Я могу его подождать здесь?<br>- Конечно, присаживайтесь вот здесь, или где вам угодно.	- ¿Puedo esperarlo aquí?<br>- Por supuesto, tome asiento aquí o donde prefiera.
- Позвольте мне посмотреть эти журналы.<br>- Это последние каталоги нашей фирмы. А вот, кажется, идёт господин Потапов.	- Permítame echar una ojeada a estas revistas.<br>- Son los últimos catálogos de nuestra empresa. Pero parece que viene el Sr. Potapov.
- Господин Вагнер! Извините, ради Бога, я опоздал.<br>- Нет, нет, вы точны, как всегда.<br>- О! Вы большой мастер говорить комплименты!	- ¡Señor Wagner! Perdóneme, por Dios, llego tarde.<br>- No, no, es Ud. puntual, como siempre.<br>- Oh, Sr. Wagner, es Ud. un maestro de decir cumplidos.
- Алло! Иван Васильевич? Я вас приветствую.<br>- А... Николай, я рад вас слышать.	- ¡Oiga! ¿Es Iván Vasilievich? ¡Buenos días! ("lo saludo").<br>- Ah, Nicolás, me alegro de oírlo.<br>
- И как вам нравится наши предложения?<br>- Я их внимательно изучил. В принципе, я не против.	- ¿Y qué le parecen nuestras propuestas?<br>- Las he estudiado a fondo. En principio, no estoy en contra.
- Мне кажется, у вас есть сомнения?<br>- Как вам сказать, кое-что надо уточнить.	- Me parece que tiene dudas.<br>- ¿Cómo decirle? Hay que precisar algunas cosas.
- Что вас смущает?<br>- Давайте лучше решим так: договоримся о встрече и всё ещё раз обсудим.	- ¿Qué le molesta?<br>- Mejor quedemos en esto: fijamos un encuentro y lo discutimos todo otra vez.
- Я - за, но когда мы можем встретиться?<br>- Завтра, например, в пятнадцать часов.	- Estoy de acuerdo, pero ¿cuándo podemos encontrarnos?<br>- Mañana, por ejemplo a las quince horas.
- У вас в бюро?<br>- Да, у меня в кабинете. Я приглашу коллег, и мы ещё раз поговорим о деталях.	- ¿En su oficina?<br>- Sí, en mi despacho. Invitaré a algunos colegas y hablaremos una vez más de los detalles.
- Полностью с вами согласен.<br>- Итак, до завтра.	- Estoy completamente de acuerdo con Ud.<br>- Entonces, hasta mañana.
- Мне нужно позвонить раньше?<br>- Нет, я вас буду ждать ровно в три часа.	- ¿Le llamo antes?<br>- No, lo esperaré a las tres en punto.
- Как вы всё успеваете?<br>- Очень просто: всё делаю вовремя. Встаю в шесть тридцать...	- ¿Cómo tiene Ud. tiempo para todo?<br>- Muy sencillo: lo hago todo a tiempo. Me levanto a las seis treinta...
- Но зачем же так рано? У вас работа начинается в десать часов.<br>- Да, но по утрам я бегаю, делаю зарядку.	- ¿Pero por qué tan temprano? Su trabajo comienza a las diez.<br>- Sí, pero por las mañanas corro, hago gimnasia.
- Господи! Каждый день?<br>- Конечно! В здоровом теле - здоровый дух. Потом холодный душ, лёгкий завтрак.	- ¡Dios mío! ¿Cada día?<br>- ¡Por supuesto! Mente sana en cuerpo sano. Después,una ducha fría y un desayuno ligero.
- А у меня всё наоборот: душ горачий, а завтрак как обед!<br>- Надо беречь здоровье: оно у нас одно. Мои дети привыкли вставать рано и бегать  вместе со мной	- Pues en mi caso es todo lo contrario: la ducha es caliente y el desayuno como un almuerzo.<br>- Hay que cuidar ("proteger") la salud: solo tenemo una. Mis hijos están acostumbrados a levantarse temprano y correr conmigo.
- А мои дочь и сын по вечерам смотрят со мной телевизор, а утром жена не может  нас поднять.<br>- Та вот... Выхожу я из дома пораньше и иду на работу пешком.	- Pues por las noches mi hija y mi hijo ven la tele conmigo, y por la mañana mi mujer no puede levantarnos.<br>- Ajá... Yo salgo de mi casa más temprano y voy al trabajo a pie.
- Всё ясно! Начинаю завтра новую жизнь. <br>- А почему завтра? Завтра - четверг, а вы начинаете новую жизнь по понедельникам.	- ¡Todo está claro! Mañana comienzo una nueva vida.<br>- ¿Y por qué mañana? Mañana es jueves, y Ud. suele comenzar la nueva vida los lunes.
- Что это мы всегда говорим о делах?  Поговорим  о чём-нибудь более приятном.<br>- Но для меня работа прежде всего.	- ¿Pero por qué hablamos siempre de trabajo? Hablemos de algo más agradable.<br>- Pero para mí el trabajo está ante todo.
- А у меня на первом месте - жена и дети.<br>- Ты у нас счастливый. У тебя жена - идеальная женщина. А у моей жены есть только один недостаток: просто ужасная память.	- Para mí en primer lugar están mi mujer y mis hijos.<br>- Es que tú eres feliz. Tu esposa es una mujer ideal. Mi mujer tiene un solo defecto: una memoria simplemente horrible.
- Как?! Она всё забывает?<br>- Нет, наоборот, всегда всё помнит.	- ¿Cómo? ¿Lo olvida todo?<br>- No, al contrario, siempre lo recuerda todo.
- Моя супруга - женщина, что надо, но любит поговорить на одну и ту же тему.<br>- А моей жене для етого совсем не нужно никакой темы.	- Mi esposa es una mujer como Dios manda, pero le gusta hablar siempre del mismo tema.<br>- La mía no necesita ningún tema para hablar ("para eso").
- Завидую я вам. Мне кажется, моя жена меня всю жизнь не понимает. А твоя, Борис?<br>- Не знаю, я никогда её не спрашивал об етом.	- Os envidio. Me parece que mi mujer no me ha comprendido nunca. ¿Y la tuya, Boris?<br>- No lo sé, no se lo he preguntado nunca.
- И всё - таки, нам повезло, друзья. Я предлагаю - за здоровье наших дам!<br>- За их здоровье! И пора домой. Нас могут не понять.	- A pesar de todo, tenemos suerte, amigos. Propongo [beber] a la salud de nuestras damas.<br>- ¡A su salud! Ya es hora de [ir] a casa. Pueden no comprendernos. 
- Что вы собираетесь делать в воскресенье?<br>- Утром прогляюсь по городу, а вечером пойду в гости.	- ¿Qué piensa hacer Ud. el domingo?<br>- Por la mañana pasearé un rato por la ciudad y por la tarde iré a casa de unos amigos.
- А может, передумаете и поедете со мной за город?<br>- С удовольствием, но мне неудобно, я уже обещал.	- ¿Puede que cambie de opinión y venga conmigo al campo?<br>- [Iría] con mucho gusto, pero sería delicado ("desagradable"), ya he prometido [ir].
- Хорошо, мы сделаем так: утром едем за город ко мне на дачу.<br>- А к вечеру мы вернёмся?	- Bueno, pues haremos así: por la mañana viene conmigo a mi dacha.<br>- ¿Y para ("hacia") la tarde volveremos?
- Приедем часов в пять.<br>- Это мне подходит.	- Volveremos sobre las cinco.<br>- Eso me va bien ("me acerca").
- Ну, вот и договорились.<br>- Значит, мы сделаем таким образом: в субботу в четыре часа я вам пазвоню и уточню время.	- Bueno, pues en eso quedamos.<br>- Entonces, haremos así: el sábado a las cuatro le llamaré y precisaré la hora.
- А может быть, мы всё решил сразу?<br>- Как вам угодно. Половина восьмого вам подходит?	- ¿Y si lo decidimos todo ahora mismo?<br>- Como quiera. ¿Le va bien a las siete y media?
- Я могу встать и пораньше.<br>- Велликолепно! Тогда ровно в семь я заеду за вами в гостиницу.<br>- Я буду ждать вас у входа.	- Puedo levantarme más temprano aun.<br>- ¡Estupendo! Entonces a las siete en punto paso al hotel a recogerlo.<br>- Lo esperaré a la entrada.
- Моя дочь мне приносит только радость.<br>- Девочки есть девочки. А мой сын чаще приносит двойки.	- Mi hija solo me trae alegrías.<br>- Las niñas son niños. Mi hijo, en cambio, me trae las más de la veces "la nota dos".
- Не обращаите внимания - Возраст.<br>- Как мне не обращать внимания? Вчера учитель истории спрашивате его: "Когда умер Александр Македонсий?"	- No le preste atención, es la edad.<br>- ¿Cómo que no le preste atención? Ayer el profesor de historia le pregunta: "¿Cuándo murió Alejandro Magno?"
- А действительно, когда? Я лично не помню.<br>- Так знаете, что он ответил: "Умер? Как жаль, а я не знал даже, что он болел".	- Sí,  efectivamente, ¿cuándo? Yo personalmente no me acuerdo.<br>- ¿Pues sabe lo que contestó?: "¿Murió? Qué pena, yo ni siquiera sabía que estuviera enfermo".
- Весьма остороумно. А я вспоминаю, как у моей дочери учительница спросила: "Катя, я не понимаю, как один человек мог сделать столько ошибок".<br>- И что же она ей отбетила?<br>- "Наталия Ивановна, я была не одна. Мне помогали мама и папа."	- ¡Muy ingenioso! Pues yo recuerdo que una profesora le preguntó a mi hija: "Katya, no entiendo cómo pudo cometer una sola persona tantos errores".<br>- ¿ Y qué le respondió ella?<br>- Natalia Ivanovna, no fui yo sola. Me ayudaron mamá y papá.
- А сегодня жена говорит сыну: "Толя, ты должен учутся музыке. Инструмент можешь выбрать сам."<br>- Предвижу ответ: гитара.<br>- Увы! Вы ошиблись. Магнитофон.	- Pues hoy mi mujer le ha dicho al chico: "Tolia, tienes que estudiar música. Puedes elegir el instrumento tú mismo.<br>- Voy a adivinar ("prever"): guitarra.<br>- ¡Qué va! Se ha equivocado. Magnetofón.
- "Мороз и солнце, удесный!"<br>- "Ещё ты дремлешь, друг прелесный...". Знаю, знаю, это Пушкин.	- "Frío y sol: ¡un día maravilloso!"<br>- "Dormitas todavía, querido amigo...". Lo conozco, lo conozco, es de Pushkin.
- Совершенно верно, Катрин, а помнишь, что дальше?<br>- Конечно, "Пора, красавица, проснись..." Я, кстати, уже почти встала, а что ты звонишь в такую рань?	- Exactamente, Catalina, ¿recuerdas cómo continúa?<br>- Naturalmente, "Ya es la hora, hermosa, despiértate..." Por cierto, yo estoy casi levantada, ¿pero por qué me llamas tan temprano?
Как! Ты забыла, мы едем кататься на лыжах/коньках. Пагода просто чудесная. По радио обещали солнце и маленький снежок.	¡Cómo! Has olvidado que vamos a esquiar/patinar. El tiempo es simplemente maravilloso. Por la radio han prometido sol y un poco de nieve.
- Насчёт солнца ваш поэт и радио правы, но вот холод ужацный!<br>- Да нет! Всего пятнадцать градусов.	- En cuanto al sol vuestro poeta y la radio tienen razón, ¡pero hace un frío horrible!<br>- ¡Qué va! Solo quince grados [bajo cero].
- Но для меня это слишком. Я люблю, когда тепло, как у нас в Англий зимой.<br>- Эх, ты! Неженка! "В зимний холод каждый молод" - говорят русские. Давай, давай быстренко одевайся, надень тёплю куртку тёплые брюки и не забудь шерстяные носки.	- Pero para mí eso es demasiado. Me gusta cuando hace calor, como en nuestra Inglaterra en invierno.<br>- ¡Cómo eres! ¡Qué alfeñique! "En el frío invernal todo el mundo es joven", dicen los rusos. ¡Venga, venga! Vístete rápido. Ponte una cazadora cálida, pantalones cálidos y no olvides los calcetines de lana.
- Может, ещё и шубу взять?<br>- Раз ты шутишь, значит, всё в порядке. Через полчаса я за тобой заеду. Будь готова.	- ¿Quizás agarro también una pelliza?<br>- Pero si estás bromeando. Eso quiere decir que todo está en orden. En media hora paso a recogerte. Estate lista.
- Николай, я еду послезавтра в Россию и хотел бы получить у тебя маленькую консультацию.<br>- Какая неожиданная новость, хотя ты уже давно собирался поехать туда. И что ты хотел знать? Чем могу, тем помогу.	- Nicolás, pasado mañana voy a Rusia y querría que me dieras algunos consejos.<br>- Qué noticia inesperada. Aunque tú hace ya tiempo que tenías intención de ir. ¿Y qué querrías saber? Te ayudaré en lo que pueda.
Дело в том, что я еду не на один день, а раньше я бывал в России, максимум пару недель, да и то всё летом.	El caso es que no voy para un día, pues antes pasé en Rusia como máximo un par de semanas, y siempre en verano.
- И надолго ты едешь? И куда?<br>- Представь себе, на год и довольно далеко - в Сибирь! Конкретно, в Иркутск.	- ¿Y para cuánto tiempo vas? ¿Y adónde?<br>- Imagínate, para un año y bastante lejos, a Siberia. Concretamente a Irkutsk.
- И конечно же, ты боишься сибирсих морозов?<br>- Ещё бы! Там, говорят, погода не дай Бог! Что зимой, что летом.	- ¿Y, naturalmente tienes miedo del frío siberiano?<br>- ¡Cómo no! Allí, según dicen, hace un tiempo que líbrenos Dios, tanto en invierno como en verano.
Это ты напрасно говоришь. Летом там тепло, даже жарко. Осенью сухо и прохладно. Весна короткая, но прекрасная.	Estás equivocado. En verano allí el tiempo es cálido, hasta caluroso. En otoño es seco y fresco. La primavera es corta, pero bonita.
- А зимой в январе, в феврале холодно. На улицу лучше не выходить?<br>- Да сказки всё это! И там живут люди и неплохо, между прочим, живут.	- Pero en invierno, en enero, en febrero hace frío. ¿Será mejor no salir de casa?<br>- ¡Si todo eso son cuentos! Allí también viven humanos y nada mal, por cierto.
- Но морозы там под сорок бивают.<br>- Бывают, и нод сорок, но зимой там сухой воздух, нет ветра. Возьми только одежду потеплее, особенно обувь. А, главное, не бойся. Там жить можно!<br>	- Pero allí la temperatura suele bajar de cuarenta.<br>- Sí, a veces baja de los cuarenta, pero en invierno el aire es seco y no hay viento. Llévate ropa más caliente y sobre todo calzado. Lo principal es que no tengas miedo. ¡Se puede vivir allí!
- Наступил так называемый "собачий холод". На улицах москвичи кричат друг другу:<br>- Просто удивительно, как холодно!	- Ha llegado el llamado "frío de perros". En las calles los moscovitas se gritan unos a otros:<br>- ¡Es simplemente sorprendente el frío que hace!
- Что же тут удивительного? Бюро прогнозов сообщает, что пришёл холодный воздух с Баренцева моря.<br>- Вот спасибо, что объяснили, а я думал, что к нам пришёл горячий аравийский воздух, и поэетому стало холодно.	- ¿Qué tiene eso de sorprendente? El servicio meteorológico anuncia que ha llegado aire frío del mar de Barentz.<br>- Gracias por la explicación, yo pensaba que nos había llegado aire caliente de Arabia y por eso había llegado el frío.
- Вот вы смеётесь, а завтра будет ещё холоднее.<br>- Не может этого быть.<br>- Уверяю вас, что обязательно будет.	- Ud. bromea, pero mañana hará más frío.<br>- Eso no puede ser.<br>- Le aseguro que será así sin falta.
Известно, что во время сильных морозов люди начинают беспричинно врать. Врут даже самые честные и правдиивые люди. Чем крепче морозы, тем крепче врут.	Se sabe que los días de frío intenso la gente empieza a mentir sin motivo. Mienten hasta las personas más honradas y leales. Cuanto más fuerte es el frío, más mienten.
Например, человек приходит в гости, долго раздевается, входит в комнату и с удовольствием объявляет: "Пятьдесят два по Реомюру".	Por ejemplo, uno va de visita, tarda mucho en quitarse el abrigo, entra en la habitación  y anuncia con satisfacción: "52 grados en la escala Réaumur".
Хозани, конечно, хочет сказать: "Что же ты в такой мороз ходишь в гости? В Такой мороз надо сидеть дома".	El anfitrión, por supuesto, quiere decir: "¿Y cómo es que con este frío vas de visita? En un frío así hay que quedarse en casa".
Но вместо этого он неожиданно говорит: "Что вы, Павел Фёдорович, гораздо холоднее. Днём было пятьдесят четыре, а сейчас, конечно, холоднее".	Pero en lugar de eso, dice inesperadamente: "Qué va, Pavel Fiodoróvich, hace mucho más frío. De día hacía 54 y ahora, por supuesto, hace más frío."
В это время приходит ещё один гость. Из коридора он радостно кричит: "Шестьдесят! Невозможно дышать, совершенно невозможно!"	Mientras tanto llega otro huésped. Desde el pasillo grita alegremente: "¡Sesenta! No se puede respirar, ¡es completamente imposible!
Все трое отлично знают, что на улице не шестьдесят, а тридцать три, и не по Реомюру, а по Цельсию.	Los tres saben perfectamente que fuera no ache sesenta, sino treinta y tres, y no en la escala Reaumur, sino en la Celsius.
Что же, пусть врут на здоровье. Может быть, им от этого делается теплее.	Pues bueno, que mientan a gusto. Puede ser que con eso entren más en calor.
Рассказывают разные истории о холодах и, конечно, кто-нибудь вспомнит о своём дедушке.	Se cuentan varias historias sobre el frío y, por supuesto, alguno se acuerda de su abuelo.
О дедушках всегда рассказывают что-нибудь интересное и геройческое.<br>Все они били здоровыми, сильными и не боялись холода.	Sobre los abuelos siempre se cuenta algo interesante y heroico.<br>Todos ellos eran sanos, fuertes y no temían al frío.
Итак, мороз, мороз! Даже трудно поверить, что есть где-то счастливые тёплые края, где, как сообщает бюро прогнозов, всего лишь десять-пятнадцать градусов ниже/выше нуля.	De todas formas, ¡el frío es el frío! Hasta es difícil creer que hay en alguna parte felices regiones cálidas donde, según dice el servicio meteorológico, solamente hace diez o quince grados bajo/sobre cero.
- Послушай, Таня, я давно хотел спросить тебя, у вас есть собака?<br>- Конечно, даже две - маленькая белая болонка и огромный пёс, правда, я не знаю, какой он породы.	- Escucha, Tania, hace tiempo que quería preguntarte: ¿tenéis perro?<br>- Naturalmente, incluso dos - un pequeño pequinés blanco y un perro enorme, que en verdad no sé de qué raza es.
- Дело в том, что мой сын просит купить ему собаку, но у нас никогда не было даже кошки.<br>- Господи! Не надо раздумывать. Конечно же, покупайте. Я считаю, для мальчика это просто необходимо.	- Es caso es que mi hijo pide que le compremos un perro pero nosotros no hemos tenido nunca ni gato.<br>- ¡Por Dios! No hay que pensárselo. Naturalmente comprádselo. Yo considero que para un chico eso es simplemente indispensable.
- Но это лишние заботы. За собакой надо ухаживать, наконец, гулять вовремя.<br>- Это же прекрасно! Помнишь, какая я была два года назад? Хмурая, вечно усталая. А, теперь... С семи до восьми я гуляю с моими собаками в парке. Вечером с девати до десяти - то же самое, и чувствую себя прекрасно.	- Pero son preocupaciones superfluas. Hay que cuidar del perro, en fin, sacarlo a pasear regularmente.<br>- ¡Si eso es maravilloso! ¿Recuerdas cómo estaba yo hace dos años? Huraña, eternamente cansada. Ahora, en cambio, de 7 a 8 paseo con mis perros. Por la noche, de 9 a 10, lo mismo, y me siento de maravilla.
- Но моя жена так любит порядок, а собака в доме?<br>- А что собака? Собака, это милое, доброе животное. Для ребёнка просто необходима собака, чтобы он был добрым и хорошим человеком.	- Pero a mi mujer le gusta tanto el orden, y ¿un perro en casa?<br>- ¿Y qué pasa con un perro? El perro es un animal amable y bueno. Para un niño es simplemente indispensable tener un perro, para que sea una persoan buena y honesta.
Всё! Ты меня убедила, завтра мы едем за собакой, тем более, что сыну через пять дней будет десять лет.	¡Basta! Me has convencido, mañana vamos a buscar un perro, tanto más que mi hijo dentro de cinco días cumplirá diez años.
Вот как это было: Принцесса была прекрасная, погода была ужасная.	Así fue todo: La princesa era hermosa, el tiempo era horrible.
Днём во втором часу заблудилась принцесса в лесу.	Durante el día en la segunda hora se perdió una princesa en el bosque.
Смотрит: полянка прекрасная, на полянке - землянка ужасная.	Mira: el prado es hermoso, en el prado hay una choza horrible.
А в землянке - людоед. <br>- Заходи-ка на обед!<br>Он хватает нож, дело ясное.	Y en la choza, un ogro.<br>- Venga, ¡entra a comer!<br>Toma un cuchillo, la cosa está clara.
Вдруг увидел, какая... прекрасная!<br>Людоеду сразу стало худо.<br>- Уходи, говорит, - отсюда. Аппетит - ужасный.	De repente vio ¡qué hermosa era!<br>El ogro en seguida se sintió mal.<br>- Vete, dice, de aquí. Mi apetito es terrible.
- Слишком вид, - говорит, - прекрасная.<br>И пошла потихоньку принцесса, прямо к замку вышла из леса.	- Eres demasiado bella, dice.<br>Y la princesa salió del bosque directamente al castillo.
Вот какая легенда ужасная!<br>А может быть, было всё наоборот???	¡Qué leyenda tan horrible!<br>¿O quizás fue todo al revés?
- Довро пожаловать в Москву, господин Смит, наконец вы прилетели. Как долетели?<br>- Спасибо, всё в порядке. Правда, были маленькие приключения. Погода в Лондоне была нелётная и мы вылетели с опозданием.	- Bienvenido a Moscú, señor Smith, por fin ha llegado. ¿Cómo fue el viaje?<br>- Todo en orden, gracias. Es verdad que he tenido pequeñas aventuras. El tiempo en Londres era inadecuado para volar, hemos salido con retraso.
- Но вы опоздали всего на час.<br>- На целый час, господин Григорьев. Я собирался прилететь несколько дней назад, но виза не была готова.	- Pero ha tenido solo una hora de retraso.<br>- Una hora entera, señor Grigoriev. Tenía la intención de venir unos días antes, pero mi visado no estaba listo.
- Приглашение мы послали вовремя на ваш факс.<br>- Кстати, господин Григорьев, огромное вам спасибо за приглашение и за предложение принять участие в вашем конгрессе.	- Le enviamos su invitación por fax a tiempo.<br>- Por cierto, sr. Grigoriev, muchísimas gracias por la invitación y por la propuesta de tomar parte en su congreso.
- Ну что вы! Ваше участие в нём большая честь для нас. А где, между прочим, ваше вещи?<br>- А вот чемодан и эта большая сумка. И ещё портфел, здесь все мой бумаги.	- ¡Pero bueno! Si su participación en él es un gran honor para nosotros. Por cierto, ¿dónde están sus cosas?<br>- Aquí está mi maleta y esta bolsa grande. Y mi cartera, donde tengo todos mis papeles.
- Кладите ваш багаж на тележку. Машина нас ждёт у входа.<br>- Я рад, что я снова в Москве. Я люблю этот город.	- Ponga su equipaje en el carrito. El coche nos espera en la entrada.<br>- Estoy contento de estar en Moscú de nuevo. Me gusta esta ciudad.
- Мне, москвичу, это слышать вдвиойне прятно.<br>- Вы слышали, по радио сообщили, что произвёл посадку самолёт из Парижа. Может быть прилетел месье Дюран?	- Para mí, que soy moscovita, es doblemente agradable oír eso.<br>- ¿Ha oído Ud.?, por la radio han anunciado que ha aterrizado el avión procedente de París. ¿Quizás ha llegado M. Durand?
Дама сдавал в багаж:<br>Диван<br>Чемодан<br>Саквояж<br>Картину<br>Корзину<br>Картонку<br>И маленькую собачонку	Una dama facturó como equipaje:<br>Un sofá<br>Una maleta<br>Una bolsa de viaje<br>Un cuadro<br>Una cesta<br>Una sombrerera<br>y una perrita pequeña
Выдали даме на станции<br>Четыре зелёных квитанций<br>О том, что получен багаж.	En la estación entregaron a la dama<br>Cuatro recibos verdes<br>De que se había recibido el equipaje.
Вещи везут на перрон,<br>Кидают в открытый вагон.<br>Готово. Уложен багаж.	Llevan las cosas al andén,<br>Las meten en un vagón abierto.<br>Listo. El equipaje está colocado.
Но только раздался звонок,<br>Удрал из вагона щенок.<br>Хватились на станции Дно:<br>Потерано место одно.	Pero en cuanto sonó el timbre,<br>saltó el cachorro del vagón.<br>Se dieron cuenta en la estación Dno:<br>Se había perdido una pieza.
Вдруг видят: стоит у колёс<br>Огромный взъерошенный лёс.<br>Поймали его - и в багаж,<br>Туда, где лежал саквояж,<br>Где прежде была собачонка.	De repente ven: junto a las ruedas hay<br>Un enorme perro desgreñado.<br>Lo agarraron y al equipaje<br>Allí, donde estaba la bolsa de viaje<br>Donde antes estaba la perrita.
Приехали в город Житомир.<br>Носильщик пятнадцатый номер<br>Везёт на тележке багаж<br>А сзади ведут собачонку.	Llegaron a la ciudad de Zhitomir.<br>El mozo número 15<br>Lleva en un carrito el equipaje<br>Y atrás conducen a una perrita.
Собака как зарычит<br>А дама как закричит:<br>- Отдайте мою собачонку!	El perro se pone a gruñir<br>Y la dama se pone a gritar:<br>- ¡Denme mi perrita!
Позвольте, гражданка! На станции,<br>Согласно бачажной квитанции,<br>От вас получили багаж<br>Маленькую собачонку	¡Con permiso, ciudadana! En la estación,<br>Según el recibo de facturación,<br>Recibieron como equipaje<br>Una perrita pequeña
Однако<br>За время пути<br>Собака<br>Могла подрасти!	Sin embargo<br>Durante el camino<br>El perro<br>¡Podía crecer!
Я поблю (повить) рыбу, и уже поймал (поймать) много рыбы.	Practico la pesca ("intento agarrar peces") y ya he cogido muchos peces.
- Простите, у вас есть свободные номера? Я хотел бы остановится в вашей гостинице.<br>- Боюсь, что я вас ничем не обрадую. Сейчас туристический сезон. А вы не заказывали номер заранее?	- Disculpe, ¿tiene habitaciones libres? Querría alojarme en su hotel.<br>- Me temo no poder satisfacerle. Ahora es la temporada turística. ¿No ha reservado habitación con antelación?
- Да, заказывал, но гостиница оказалась слишком далеко от центра.<br>- Постараемся чем-нибудь вам помочь. Мне кажется, вам повезло. Есть очень хороший номер на одночо на втором этаже.	- Sí, la reservé, pero resulta que está demasiado lejos del centro.<br>- Vamos a intentar ayudarle. Me parece que tiene suerte. Hay una habitación individual muy buena en el primer piso.
- Да, но мне нужен номер на двоих. Я приехал в Москву с женой.<br>- Это, узе посложнее... хотя... одну минуточку. Всё в порядке, есть номер на двоих на третьем этаже.<br>Правда, окна выходят на улицу.	- Eso ya es más complicado... aunque... un momentito. Todo está en regla, hay una habitación para dos en el segundo piso. Es verdad que las ventanas dan a la calle.
- Это не важно. Днём мы в гостинице практически не будем, а ночью, как я думаю, на улице не так шумно.<br>- Вы абсолютно првы. Если вы согласны, то заполните, пожалуйста, вот этот бланк. Кстати, сколько времени вы будете в Москве?	- Eso no importa. De día prácticamente no estaremos en el hotel, y por la noche, creo que no hay tanto ruido en la calle.<br>- Tiene Ud. toda la razón. Si está de acuerdo, rellene, por favor, este formulario. A propósito, ¿cuánto tiempo estarán en Moscú?
- Дней пять, не больше. Мы ещё собираемся съездить в Санкт-Петербург.<br>- Вот ваши ключи. Ваш номер на третьем этаже, лифт перед вами. Горничная на этаже вам покажет ваш номер.	- Unos cinco días, no más. Tenemos la intención de ir también a San Petersburgo.<br>- Aquí tiene las llaves. Su habitación está en el segundo piso. El ascensor lo tienen delante. En el piso, la camarera les mostrará la habitación.
- Огромное вам спасибо. Я могу оплатить номер сейчас?<br>- Как вам угодно. Можете сейчас, можете потом. Я думаю, вам у нас понравится. Кстати, ресторан на первом этаже. Там вы будете завтракатъ. Всего вам доброго!	- Muchísimas gracias. ¿Puedo pagar la habitación ahora?<br>- Como quiera. Puede ahora o más tarde. Creo que le va a gustar nuestro hotel. POr cierto, el restaurante está en la planta baja. Allí van a desayunar. ¡Feliz estancia!
- Здравствуй, дорогой! Мы с тобой не виделись вечность, а надо бы повидаться, поболтать, или ты, как всегда, по уши в работе?<br>- Работа не волк, как говорят, в лес не убежит, а встретится и пообщаться, действительно, нужно бы.	- ¡Hola querido! Hace una eternidad que no nos vemos, y sería bueno vernos un poco, charlar, o tú, como siempre, ¿estás "hasta las orejas de trabajo"?<br>- El trabajo como dicen, no es un lobo, no correrá al bosque, y efectivamente, deberíamos vernos y hablar.
- Так в чём дело? У меня есть два билета в театр на сегодня. Давай сходим.<br>- Ты не можешь жить без  сюрпризов. А куда билеты и на что?	- ¿De qué se trata? Tengo dos entradas al teatro para esta noche. Vamos.<br>- No puedes vivir sin sorpresas. ¿Y para dónde y para qué son las entradas?
- О дорогой! Билеты я достал по великому блату. Вернее, мне их подарили. А пойдём мы с тобой во МХАТ и будем смотреть пьесу Вампилова "Утиная охота".<br>- Я эту пьесу уже видел в Иркутске, но во МХАТ скожу с опгромным удовольствием. Говорят, постановка отличная.	- ¡Oh, querido! Las entradas las he conseguido con un gran enchufe... Más exactamente, me las han regalado. Iremos al MJAT a ver la obra de Vampilov "La caza de patos".<br>- Yo ya vi esa obra en Irkutsk, pero iré al MJAT con muchísimo gusto. Se dice que la puesta en escena es magnífica.
- И постановка, и игра атёров. Сегодня, главую роль исполняет молодой актёр, который мне очень нравится. Во МХАТе всегда прекрасные артисты.<br>- Скажи, пожалуйста, а где наши места?<br>В партере?	- La puesta en escena y la interpretación de los actores. Hoy representará el papel principal un actor joven que me gusta mucho. En el MJAT los artistas son siempre buenos.<br>- Dime por favor, ¿dónde están nuestros asientos? ¿En el patio de butacas?
- На этот раз мы будем сидеть на балконе. Оттуда всё видно и слышно прекрасно.<br>- Спасибо тебе, я просто не знал, как убить вечер. Да, кстате, а кто режиссёр спектакля?	- Esta vez nos sentaremos en la galería. Desde allé se ve y oye todo excelentemente.<br>- Gracias, yo simplemente no sabía cómo pasar noche. A, por cierto, ¿quién es el director de la función?
- Я не знаю. Я хожу в театр от случая до случая. В театре купим программу и всё узнаем. Не збудь, спектакль начинается ровно в семь, и после звонка в зал нельзя входить.<br>- Я буду у входа за полчаса до начала спектакля. Приходи пораньше. Забежим в буфет и выпьем по чашечке кофе.	- No lo sé. Voy al teatro muy de vez en cuando. En el teatro compraremos un programa y lo averiguaremos todo. No olvides que la función comenza a las siete en punto, y después del timpre no se puede entrar en la sala.
Ирония судьбы	Ironía del destino
- Алло? Москва? Позовите, пожалуйста, Галю. Это Галя? А Женя уже ушёл на аэродром.<br>- А кто вы такая?<br>- Случайная знакомая.	- Oiga ¿Moscú? Páseme a Galia, por favor. ¿Es Ud. Galia? Zheña ya ha ido al aeropuerto.<br>- Pero, ¿quién es Ud.?<br>- Una conocida casual
- А как он оказался у вас в квартире?<br>- Сейчас я вам всё объясню. Женя вчера пощёл в баню...<br>- Это у них традиция. Женя и его школьные друзья каждый год тридцать первого декабра ходят в баню.	- ¿Y cómo apareció él en su piso?<br>- Ahora le explicaré todo. Zheña ayer fue a los baños...<br>- Esa es una tradición suya, Zheña va con sus compañeros de escuela a los baños cada 31 de diciembre.
- Откуда вы это знаете? Значит, вы знакомы много лет?<br>- Нет, мы познакомились несколько часов <br>назад. Вы поймите, мой адрес в Ленинграде такой же, как у него в Москве... Он по ошибке полал в Ленинград и пришёл ко мне, как к себе домой.	- ¿Cómo lo sabe Ud.? ¿Significa que hace muchos años que lo conoce?<br>- No, nos conocimos hace unas horas. Comprenda, mi dirección en Leningrado es la misma que la suya en Moscú. Por equivocación se encontraba en Leningrado y llegó a mi casa, como a la suya.
- Я всё поняла. Вы даже знаете его московский адрес.<br>- Галя, Галя... Толька не вешайте трубку. Вы нечего не поняли... Ваш Женя добрый, славный... он ни в чём виноват... И я вам немного завидую... Вы знаете, он мне очень понравился... Простите его...	- He comprendido todo. Hasta se sabe Ud. su dirección de Moscú.<br>- Galia, Galia... No me vaya a colgar. No ha comprendido nada... Su Zheña es bueno, honrado... Hasta la envidio un poco.. Sabe, él me ha gustado mucho... Perdónele...
- Почему вы его защищаете? Вы замужем?<br>- Какое это имеет значение?<br>- Значит, не замужем... И он улетел в Ленинград, встречать с вами Новый год.<br>- Это было не так.	- ¿Por qué lo defiende? ¿Está Ud. casada?<br>- ¿Qué importancia tiene eso?<br>- Es decir que no está casada... Y él voló a Leningrado a recibir el año nuevo con Ud.<br>- No fue así.
- Последний шанс?<br>- Как вам не стыдно?<br>- Это мне стыдно? Я у вас жениха не крала! 	- ¿Última oportunidad?<br>- ¿Cómo no le da vergüenza?<br>- ¿Vergüenza, yo? ¡Yo no le he quitado el novio!
- Вы всё неправильно понимаете.<br>- Вы хищница! Но всё равно, у вас ничего не выйдет! В последний момент он всё равно сбежит.	- Comprende Ud. todo mal.<br>- ¡Ud. es una víbora! Pero es igual, no logrará nada. En el último momento él se escapará de todas formas.
- Какое сегодня число?<br>- Первое Августа.<br>- А когда вы удете?<br>- Пятого февряла.	- ¿Qué fecha es hoy?<br>- Uno de agosto.<br>- ¿Y cuándo salís de viaje?<br>- El cinco de febrero.
- Друзья мои! Что это вы приуныли, головы повесили? На улице такая красота! Тепло, солнечно. Даже по радио обещали прекрасную погоду без перемен.	- ¡Amigos míos! ¿Por qué estáis tan abatidos, por qué agacháis la cabeza? Fuera hace un tiempo maravilloso. Calor, sol, incluso por la radio han prometido un tiempo muy bueno sin cambios.
- Ты знаешь, мы оказались в глупом положении. Целый час ждём Михаила. Он обещал нас повозить по городу, но сам как в воду канул.	- Sabes, resulta que estamos en una situación tonta. Hace una hora entera que esperamos a Mijail. Prometió llevarnos por la ciudad, pero ha desaparecido "como el agua".
- "Обещанного три года ждут", говорят русские, но мы не станем этого делать. Быстро - спортивные костюмы, не забудьте плавки и за город, на Москву-реку.	- "Lo prometido se espera tres años", dicen los rusos, pero nosotros no vamos a hacer eso. Rápido, ropa deportiva, no olvidéis los bañadores a vamos al campo, a la orilla del río Moscú.
- Что тебе пришло в голову?! Первый тёплый день в Москве, и сразу же дупаться и загорать!	- ¿Qué se te ha ocurrido? El primer día de calor en Moscú y ¡enseguida a bañarse y a tomar el sol!
- Ну, ребята, с вами каши не сваришы! Хорошо, если вы такие неженки, я предлагаю пройтись по городу пешком, а гидом буду я. Итак, ваши пожелания господа?	- Pues, hijos míos, "con vosotros no se cocerá la kasha". Bueno, si sois así, os propongo dar un paseo por la ciudad y el guía seré yo. Entonces, ¿sus deseos, señores?
- Я хотела бы побывать в Коломенском.<br>- А мне так хочется попасть в ботанический сад. Там уже лето - зелень, поют птицы, цветут деревья и цветы...	- Me gusataría ir a Kolomenskole.<br>- Yo tengo ganas de ir al jardín botánico... Allí ya ha llegado el verano, los pájaros cantan, florecen los árboles y las flores...
- А я мечтаю посетить какой-нибудь музей и осмотрерть старую Москбу.	- Pues yo sueño con visitar algún museo y ver el Moscú anterior.
- Вы смотрите, кто пришёл! Наш догложданный Михаил. Ура! На "Волге" мы повсюду побываем. Как говорят: "Всем сестрам - по серьгам". Но прежде объясин, что с товой случилось?<br>- Потом, потом! Время не терпит. Машина у подъезда. В путь, друзья!<br>	- ¡Mirad quién ha llegado! Nuestro esperado Mijail. ¡Hurra! Con el "Volga" iremos a todas partes. Como dicen: "A cada hermana - su par de pendientes". Pero primero explica, ¿qué te ha pasado?<br>- ¡Luego, luego! No hay tiempo. El coche está a la entrada. ¡En camino, amigos!
- Эх! Какой русский не любит быстрой езды! Пристегнитесь, друзья. Я прокачу вас с ветерком!<br>- Миша, только без етого! Слова Гороля о русских, боюсь, не пазделяют московские милицонеры.	- ¡Eh! ¿A qué ruso no le gusta la velocidad? Abrochad los cinturones, amigos. ¡Os llevaré con el viento!<br>- Misha, ¡todo menos eso! Me temo que los policías de Moscú no comparten las palabras de Gogol sobre los rusos.
- Не бойтесь! Авось нам повезёт, и мы побываем везде, где вашей душе будет угодно.<br>- Это как раз тот случай, когда говорят, что русские долго запрягают, да быстро идут.	- ¡No tengáis miedo! A lo mejor tenemos suerte y vamos a todas partes donde os apetezca.<br>- Esta es precisamente una de las ocasiones de las que dicen que a los rusos les cuesta salir ("tardan en enganchar") pero luego van rápido.
- Нашёк ваш понял. А впрочем, куда нам спешить, весь день впереди. - Кстати, обратите внимание направо. Это памятник Гоголю. Мы проезжаем по Гололевскому бульвару.	- Has comprndido la indirecta. Por lo demás, ¿por qué correr?, tenemos todo el día por delante. - A propósito, prestad atención a la derecha. Es el monumento a Gogol. Vamos por la Avenida Gogol.
- Мне помнится, сейчас откроется прекрасный вид на Кремль. Я уже здесь дважды проезжал.	- Me acuerdo de que ahora se va a abrir una vista espléndida sobre el Kremlin. Ya he pasado por aquí dos veces.
"Москва, Москва!... Люблю тебя, как сын, как русский, пламенно и нежно!" Я всегда вспомнаю эте слова Лермонтова, когда смотрю на Кремль с Каменного моста.	"¡Moscú, Moscú!... ¡Te quiero, como hijo, como ruso, con ardor y con ternura!" Siempre recuerdo esas palabras de Lermontov cuando miro el Kremlin desde el Puente de piedra.
- Жак, ты знаешь, за что я люблю теба? Ты просто энциклопедия русской классики, да и истории тоже. Кстати, когда был основан Кремль?<br>- Вопрос дла первоклассика. В двенадцатом веке были построены его первые деревянные стены. А вот колокольня "Иван Великий" была построена в начале шестнадцатого века.	- Jacques, ¿sabes por qué te quiero? Eres simplemente una enciclopedia de los clásicos ruso, y también de la historia. Por cierto ¿Cuándo fue fundado el Kremlin?<br>- Es una pregunta para un alumno de primaria. Sus primeras paredes de madera fueron construidas en el siglo doce. El campanario "Iván el Grande" fue construido a principios del siglo dieciséis.
- Миша, я вас прошу остановится здесь. Я хотела бы посмотреть этот книжный базар.<br>- Я сделал бы это с удовольствием, но здесь стоянка запрещена. А впрочем, рискнём.	- Misha, te pido que pares aquí. Querría ver este mercadillo de libros.<br>- Lo haría con mucho gusto pero aquí está prohibido aparcar. Pero nos arriesgaremos.
- Как там у вас, Жак, говорят?<br>- Кто не рискует, тот не пьёт шампанского.	- ¿Cómo se dice en vuestro país, Jacques?<br>- El que no se arriesga, no bebe champán.
- Мне очень знакомо ваше лицо. Мне кажется, мы где-то встречались.<br>- И не однажды, Каждый раз, когда я приезжаю в Москву, я захожу в ваш магазин.	- Me suena mucho su cara. Me parece que ya nos hemos encontrado en algún lugar.<br>- Y no una vez. Cada vez que vengo a Moscú, vengo a su tienda.
- А, да, припоминаю. Послединй раз вы интересовались русской живописью.<br>- И вы тогда мне не смогли предложить нечего интересного.	- Ah, sí, ya me acuerdo. La última vez Ud. se interesó por la pintura rusa.<br>- Y Ud. entonces no pudo recomendarme nada interesante.
- Зато сейчас у нас книги на любой вкус. Что вы хотели бы купить у нас в этот раз?<br>- Меня, как и прежде, интерсуют русские художники, но сейчас у меня появилось новое увлечение - русский театр.	- En cambio ahora tenemos libros a su gusto. ¿Qué quiere comprarnos esta vez?<br>- Como antes, me interesan los artistas rusos pero ahora tengo una nueva afición: el teatro ruso.
- Нет проблем. Вот русская классика от восемнадцатого века до наших дней, а вот пьесы последних лет.<br>- Дайте, пожалуйста, посмотреть этот сборник Вампилова. Сколько это стоит?	- Ningún problema. He aquí los clásicos rusos desde el siglo XVIII hasta nuestros día. Y aquí están las obras de los últimos años.<br>- Déjeme ver, por favor, esa recopilación de Vampilov. ¿Cuánto cuesta?
- Совсем недорого по нынешним временам - сорок рублей.<br>- Ну, за такую книгу это не деньги. Я беру Вампилова. А что  интересного вы мне можете предложить из живописи?	- No es caro para los tiempos que corren: 40 rublos.<br>- Efectivamente, por un libro así no es dinero. Me quedo a Vampilov. ¿Y qué hay de interesante en pintura que me pueda recomendar?
- Всё, что хотите. Во совсем новенький альбом Нестерова и стоит сравнительно дёшево.<br>- Какое прикрасное издание! У нас этот художник почти неизвестен, но его картины великолепны. Как говорил Пушкин: "Здесь русский дух... Здесь Пусью пахнет."	- Todo lo que quiera. He aquí un álbum nuevecito de Nesterov, y cuesta relativamente barato.<br>- ¡Qué bonita edición! Entre nosotros este pintor es casi desconocido pero sus cuadros son magníficos. Como decía Pushkin: "Aquí está el alma rusa... Aquí huele a Rusia".
- Как интересно! Совсем недавно мы с вами говорили почти на пальцах, а теперь вы цитируете русские стихи и читаете пьесы по-русски.<br>- Всё дело в методе. Я изучаю руссий язык по системе "Ассимиль", а главное, всегда интересовался вашей страной.	- ¡Qué interesante! No hace mucho Ud. y yo hablábamos casi con las manos ("dedos"), y ahora cita Ud. poemas rusos y lee dramas en ruso.<br>- Todo es cuestión del método. Estudio ruso con el método "Assimil" y lo principal es que siempre me he interesado por su país.
Валентина, ты замечательная девушка. Всё у тебя на лице - все твои тайны.<br>Ты не уехала, потому что ты влюбилась... Разве нет? А в кого, интересно? Не скажешь? Ну ещё бы!	Valentina, eres una muchacha admirable. Lo llevas todo en la cara; todos tus secretos.<br>No te has ido porque te has enamorado... ¿No es así? ¿Y de quién? ¿No lo dirás? ¡Claro que no!
Ах, Валентина, грустно мне на тебя смотреть. Грустно, потому что меня уже никогда не полюбит такая девушка, как ты.	Ah,Valentina, me entristece mirarte. Me entristece porque de mí ya no se enamorará nunca una muchacha como tú.
- Что неправда? Кому же, интересно, я могу понравиться? Что-то не вижу я желающих... Может, ты кого знаешь?<br>- Все знают, кроме вас.<br>- Вот как!	- ¿Qué no es verdad? Ya me gustaría saber a quién puedo gustar. No veo a demasiadas enamoradas. ¿Quizás tú sabes de alguien?<br>- Todos los saben, menos Ud.<br>- Vaya.
- Вы один здесь такой: ничего не видите... Вы слепой! Слепой - ясно вам?<br>- Ты это серьёзно? Ты уверена, что...?	- Ud. es el único aquí así: no ve nada... ¡Está ciego! Ciego, ¿le queda claro?<br>- ¿Lo dices en serio? ¿Estás segura de que...?
- Слепой... но не глухой же вы, правда же?<br>- Да нет, Валентина, не может етого быть... Ну вот ещё! Нашла объект внимания. Откровенно говоря, ничего хуже меня ты не могла придумать...	- Ciego... pero sordo no es, ¿verad?<br>- No, no, Valentina, eso no puede ser... ¡Buenos estamos! Has encontrado un objeto de atención. Sinceramente, no habrías podido imaginar nada peor que yo.
Ты славная девочка, ты прелесть, но то, что ты сейчас сказала, это ты выбрось из головы... Забудь и никогда не вспоминай... И вообще: ты ничего не говорила и я ничего не слышал... Вот так.	Eres una buena muchacha, un encanto, pero lo que has dicho ahora, quítatelo de la cabeza... Olvídalo y no lo recuerdes nunca más. Además, tú no has dicho nada y yo no he oído nada. Y ya está.
- Я не сказала бы никогда. Вы сами начали.<br>- Я пошутил. Постой... Валентина! Ну вот... Только етого мне и недоставало.	- Yo no lo hubiera dicho nunca. Ud. empezó.<br>- Yo bromeaba. ¡Espera... Valentina! ¡Qué lío!... Solo m faltaba esto.
- Ты знаешь, мой сынок сегодня прибежал из школы и с порога: Мама, хочешь новый анекдот?<br>- Могу себе представить! Какая-нибудь очередная гадость!	- ¿Sabes? Hoy mi hijo ha vuelto corriendo del colegio y "desde el umbral" [me ha dicho]: Mamá, ¿quieres oír un nuevo chiste?<br>- Me lo puedo imaginar, una majadería como siempre.
- Ты, как всегда, права. Вот слушай: "Директор школы входит в класс и видит: полкласса смеётся, а другая половина плачет.	- Como siempre, tienes razón. Escucha: "El director de la escuela entra a la clase y ve: la mitad de la clase ríe y la otra mitad llora.
- Ребята, вы почему смеётесь?<br>- Учитель наш из окна быпал!<br>- А вы что плачете?<br>- А мы этого не видели!	- Chicos, ¿por qué os reís?<br>- ¡Nuestro maestro se cayó por la ventana!<br>- ¿Y vosotros por qué lloráis?<br>- ¡Nosotros no lo vimos!
- Вот видишь! Мы были другими, да и анекдоты были совсем незлыми, а добрыми.<br>- Не говори! Я до сех пор один пмню.	- Ya ves. Nosotros éramos distintos, no los chistes eran tan malvados, sino graciosos.<br>- ¡Ni que lo digas! Yo todavía recuerdo uno.
Мальчик спрашивает приятеля:<br>- Почему твой братик всё время плачет?<br>- Если бы у тебя не было зубов и не было болос, если бы ты не умел ходить и не умел говорить, ты бы ещё не так рыдал!	Un chico pregunta a su amigo:<br>- ¿Por qué llora tu hermanito todo el tiempo?<br>- Si no tuvieras dientes ni pelo, si no supieras caminar ni hablar, ¡tú llorarías más!
- А мой муж сам просто анекдот. Он Серёжу всё ещё маленьким считает.<br>Как только на экране телевизора появляются почти раздетые девицы, он говорит: ...	- Pues mi marido es él mismo un chister. Todavía considera que Seriozha es pequeño.<br>En cuanto aparecen en la pantalla del televisor mujeres casi desnudas, dice: ...
- Всё, Серёжа, пора спать, видишь, тёти уже парделись и тоже идут спать.<br>- А они понимают в сто раз больше, чем в их годы.	- Eso es todo, Seriozha. es hora de dormir, ves, las señoras ya se han quitado la ropa y se van a dormir.<br>- Pero ellos comprenden cien veces más que nosotros a su edad.
-  Вот и моего на уроке ботаники учительница спрашивает:<br>- Миша, расскажи, как размножаются растения.<br>- Растения? - он отвечает, вот о них я и ничего не знаю.	- Al mío le pregunta la maestra en clase de botánica:<br>- Misha, cuéntame cómo se reproducen las plantas.<br>- ¿Las plantas? - responde él - pues de las plantas no sé nada.
- Я, отровенно говоря, не очень люблю музей. Когда бываю в незнакомых городах, прредпочитаю гулять по городу, смотреть а людей...<br>- А я обожаю посещать музей, галерей... И не обязательно очень известные.	- A mí, a decir verdad, no me gustan los museos. Cuando estoy en ciudades desconocidas prefiero pasear por la ciudad, mirar a la gente...<br>- Pues a mí me encanta visitar museos, galerías... y no necesariamente los muy famosos.
- Но сегодня мы посмотрим необыкновенный музей. А вот и она - Третьяковка! Друзья, перед вами Третьяковская галерея.<br>- Всю жизнь мечтал побывать здесь. Но всё как - то не получалось. То мне было никогда, то галерея была закрыта на реставрацию.	- Pero hoy vamos a ver un museo fuera de lo común. Aquí está: ¡la Tretiakova! Amigos, ante vosotros, la galería Tretiakova.<br>- Toda la vida he soñado venir aquí. Pero siempre me lo ha impedido algo. O no tenía tiempo, o la galería estaba cerrada por restauración.
- Друзья, вы посмотрите лучше на это чудесное здание. Оно стало красивее, чем было раньше.	- Amigos, mirad bien este edificio maravilloso. Se ha vuelto más bonito de lo que era.
- Катя, когда и кем была основана галерея? И почему она называется Треьяковская?<br>- Сама галерея была основана фабрикантом Третьяковым в тысяча восемьсот пятидесятом году, а здание было построено через тридцать лет.	- Katia, ¿cuándo fundaron la galería? ¿Y por qué se llama Tretiakov?<br>- La galería misma fue fundada por el magnate industrial Tretiakov en 1850, y el edificio fue construido 30 años después.
- Я читал, что Третьяков собрал  около трёх тысяч картин, а потом, кажется, в тысяча восемьсот девяносто втором году, подарил её городу Москве.<br>- Друзья, минуточку внимания, перед вами, самое знаменитое полотно галереи "Иван Грозный и сын его Иван шестнадцатого ноября тысача пятьсот восемьдесят первого года".	- He leído que Tretiakov reunió unos tres mil cuadros, y luego, me parece que en 1892, los donó a la ciudad de Moscú.<br>- Amigos, un minutito de atención: delante vuestra está la pintura más famosa de la galería, "Iván el Terrible y su hijo Iván, el 16 de noviembre de 1861".
- Если я не ошибаюсь, это Илья Репин. Какой ужасный царь! России на царей не всегда везло. Я хотел бы взглянуть на Левитана.<br>- А вот и твой любимый Левитан - друг Чехова, мастер русскогопейзажа, Чайковский русской живописи. Его картины не могут не нравиться.	- Si no me equivoco, es de Ilia Repin. ¡Qué zar más horrible! Rusia no siempre tuvo suerte con los zares. Me gustaría echar un vistazo al Levitán.<br>- He aquí tu querido Levitán, amigo de Chéjov, maestro del paisaje ruso, el Chaikovski de la pintura rusa. Sus cuadros no pueden no gustar.
- О! Остановитесь! Это "Демон", знаменитый, одинокий, лермонтовский Демон. Я столько раз видел репродукции этого шедевра, и вот он передо мной. Вы идите, я постою здесь. Идите, идите. "Печальный Демон, дух изгнания".	- ¡Oh! ¡Paraos! Éste es "El Demonio", el famoso, solitario Demonio de Lermontov. Tantas veces he visto la reproducción de esta obra maestra y ahora está delante de mí. Seguid adelante, yo me quedo aquí. Seguid, seguid. "Triste Demonio, espíritu del desierto".
- Друзья, давайте быстренько просмотрим другие залы, а потом ещё придём сюда. Как жаль, что у нас так мало знают русскую живопись!	- Amigos, vamos rápido a ver las otras salas, y luego volveremos aquí. Qué lástima que en nuestro país se conozca tan poco la pintura rusa.
- Хотите, я узнаю у вас характер. Вернее, не я, а компьютер. А я задам вам несколько вопросов. Вы готовы?<br>- Любопытно. Я никогда не задумюбался об этом. Характер как характер. Особых проблем он мне никогда не доставлал. Но всегда интересно, что о тебе скажут другие, простите, что скажет ваш компьютер.	- Si quiere, averiguaré cómo es su carácter. Mejor dicho, no yo, sino la computadora. Yo le haré algunas preguntas. ¿Está listo?<br>- Es curioso. Nunca me he parado a pensar en eso. Mi carácter es como es. Nunca me ha causado problemas especiales. Pero siempre es interesante saber qué dirán de ti los otros, perdón qué dirá su computadora.
- Когда вы родились, в каком месяце, какого числа?<br>- Я родился в тысяча девятьсот шестьдесят четвёртом году, шестого мая.	- ¿Cuándo nació Ud. en qué mes, qué día?<br>- Nací en 1964, el 6 de mayo.
- Что вы  любите делать в свободное время? Путешестовать или оставаться дома?<br>- Это зависит. Летом я предпочитаю путешестовать, а зимой мне по душе сидеть дома. Мне нравится что-нибудь читать, сидеть просто рядом с женой с детьми.	- ¿Qué le gusta hacer en su tiempo libre? ¿Viajar o quedarse en casa?<br>- Depende. En verano prefiero viajar pero en invierno me gusta más estar en casa. Me gusta leer algo, estar junto a mi mujere y mis hijos.
- Кстати, а сколько у вас детей?<br>- Два мальчика и девочка - моя любимица. Да вы её видели - прелесть девчонка, да и ребята пока меня только радуют.	- A propósito, ¿cuántos hijos tiene?<br>- Dos niños y una niña, mi favorita. Si Ud. la viera, es un encanto de niña, pero los chicos me dan también solo alegrías.
- Что вы предпочитаете носить? Одежду классического стиля или остромодные вещи?<br>- Пожалуй, сейчас я люблю спокойные тона, классические костюмы, но иногда могу удивить друзей чем-нибудь оригинальным, например, смелым сочетанием цветов рубашки и галстука.	- ¿Qué prefiere ponerse? ¿Ropa de estilo clásico o de última moda?<br>- Bueno, ahora me gustan los tonos suaves, los trajes clásicos, pero a veces puedo sorprender a los amigos con algo original, por ejemplo, con una combinación atrevida de colores de la camisa y la corbata.
- Вам нравится проводить время в кругу друзей? Вы любите шумные вечеринки иле отдаёте предпочтение тихим и солидным беседам?<br>- Мне что-то не очень нравится ваш вопросник. Я люблю и то, и другое. Всё зависит, как говорят, когда, где и с кем. Правда, слишком шумные вечеринки не в моём вкусе.	- ¿Le gusta pasar el tiempo con sus amigos? ¿Le gustan las fiestas ruidosas o prefiere las conversaciones tranquilas y serias?<br>- Hay algo que no me gusta en su cuestionario. Me gusta esto y lo otro. Todo depende, como se dice, del cuándo, dónde y con quién. Aunque es verdad que las fiestas muy ruidosas no son de mi gusto.
- Давайте посмотрим, что у нас получилось. Вы близки к "золотой середине". Человек вы осмотрительный. Нельзя сказать, что вы склонны к приключениям. Вы надёжная опора для семьи и друзей, но...<br>- Всё, всё! Хватит обо мне. Пусть ы меня останутся маленькие тайны.	- Vamos a ver cuál es el resultado. Ud. está cerca de la "mitad de oro". Es una persona prudente. No puede decirse que sea proclive a las aventuras. Es el firme apoyo de su familia y amigos, pero...<br>- ¡Basta, basta! Suficiente sobre mí. Déjeme mis pequeños secretos.
- Чего ты сегодня пасмурен?<br>- Я? нет!	- ¿Por qué está hoy tan apesadumbrado ("nublado")?<br>- ¿Yo? ¡No!
- Ты, верно, Моцарт, чем-нибудь расстроен? Обед хороший, славное вино, а ты молчишь и хмуришься.<br>- Признаться, мой Requiem меня тревожит.	- Mozart, seguramente te abruma algo. La comida es buena, el vino, excelente, pero tú estás callado y tienes un aire taciturno.<br>- Debo reconocer que  mi Requiem me atormenta.
- А! Ты сочиняешь Requiem? Давно ли?<br>- Давно, недели три. Но странный случай... Не сказывал тебе Я?<br>- Нет.	- ¡Ah! ¿Compones un Requiem? ¿Hace mucho?<br>- Hace mucho, unas tres semanas. Pero el caso es extraño. ¿No te lo había dicho?<br>- No.
- Так слушай: недели три тому, пришёл я поздно домой. Сказали мне, что заходил за мною кто-то. Отчего - не не знаю. Всю ночь я думал: кто бы это был?	- Entonces escucha: hace unas tres semanas, llegué a casa tarde. Me dijeron que alguien me había buscado. Por qué, no lo sé. Toda la noche estuve pensando: ¿quién sería?
И это ему во мне? Назавтра тот же зашёл не застал опять меня.<br>На третий день играл я на полу с моим мальчишкой. Кликнули меня.	¿Y qué querría de mí? Al día siguiente volvió a pasar y tampoco me encontró.<br>El tercer día estaba yo jugando con mi chiquito en el suelo. Me llamaron.
Я вышел. Человек, одетый в чёрном, учтиво поклонившись, заказал мне Requiem и скрылся. Сел я тотчас и стал писать, и с той поры за мною не приходил мой чёрный человек.	Salí. Un hombre vestido de negro, tras saludarme cortesmente, me encargó un Requiem y desapareció. Me senté en seguida y me puse a escribir, y desde aquel momento mi hombre de negro no me ha buscado.
- А я и рад, мне было б жаль расстаться с моей роботой, хоть совсем готов уж Requiem. Но между тем, я...<br>- Что?	- Estoy al mismo tiempo contento, porque me daría pena separarme de mi trabajo, aunque ya está casi hecho el Requiem. Pero mientras tanto...<br>- ¿Qué?
- Мне совестно признаться в этом...<br>- В чём же?<br>- Мне день и ночь покоя не даёт мой чёрный человек. За мною всюду как тень он гонится. Вот и теперь, мне кажется, он с нами сам-третий сидит.	- Me da vergüenza reconocer eso...<br>- ¿Qué?<br>- Mi hombre de negro no me deja en paz ni de día ni de noche. Corre detrás de mí como mi sombra. Ahra mismo, me parece que está con nosotros.
- И полно! Что за страх ребячий? Рассей пустую думу. Бомарше говаривал мне: "Слушай, брат Сальери. Как мысли чёрные к тебе придут, откупорь шампанского бутылку, иль перечти "Женитьбу Фигаро".	- ¡Basta! ¿Qué es ese miedo infantil? Disipa esa vana idea. Beaumarchais solía decirme: "Escucha, Salieri, hermano mío. Cuando te invadan ideas negras, abre una botella de champán, o relee "Las Bodas de Fígaro"."
- Сегодня вечером вы куда-нибудь уходите?<br>- Нет, я никуда не ухожу, посижу дома, поиграю со своим мальчишкой.	- ¿Va Ud. a algún lugar esta noche?<br>- No, no voy a ningún sitio. Estaré en casa, jugaré con mis niños.
- Если вы не переменили намерения путешествовать с нами, мы заедем за вами в пятницу вечером.<br>- Признаться, я ещё не решила. Дайте мне подумать ещё день.	- Si no ha cambiado de opinión sobre viajar con nosotros, pasaremos a recogerla el viernes por la tarde.<br>- Debo reconocer que todavía no me he decidido. Déjeme un día más para pensar.
- Дорогая, я думаю, нам пора одеваться и ехать в гости, нас уже ждут.<br>- Прости, но я не могу решить, какое платье мне сегодня надеть.	- Querida, creo que ya es hora de vestirnos e ir de visita, nos esperan.<br>- Perdona, pero no puedo decidir qué vestido ponerme hoy.
- Ах, вы болтунишка! Вы разболтали все наши тайны.<br>- Уверяю вас, что это не так. Вы ошибаетесь.	- ¡Ah, eres un chismoso! Has divulgado todos nuestros secretos.<br>- Le aseguro que eso no es cierto. Se equivoca.
- Заходите к нам почаще. Мы всегда рады гостям.<br>- К вам я всегда прохожу с удоволствем.	- Venga a vernos más a menudo. Nos alegramos de las visitas.<br>- Siempre vengo a su casa con mucho gusto.
- Странный случай! Весь день змоню домой, и никто не отвечает.<br>- Обычное дело. У детей каникулы, и я не думаю, что они будут сидеть дома.	- ¡Qué caso más extraño! Todo el día llamo a casa y no me contesta nadie.<br>- Es normal. Los niños tienen vacaciones y no creo que se queden en casa.
- Хотите анекдот?<br>- Надеюсь, новый, а не с бородой.<br>- Всё новое - хорошо забытое старое.	- ¿Quieres [que te cuente] un chiste?<br>- Espero que sea nuevo, no "con barba" (muy visto).<br>- Todo lo nuevo es algo viejo bien olvidado.
Так вот, ученика спрашивает учитель анатоми:<br>- Какие зубы появляются у человека в последнюю очередь?<br>- Вставные, Иван Владимирович.	Va el profesor de anatomía y le pregunta a un alumno:<br>- ¿Cuáles son los dientes que aparecen más tarde en el ser humano?<br>- Los postizos, Iván Vladimirovich.
- Кстати, на днях мне вставили два новых зуба. Доктор уверял меня, что они будут как настоящие.<br>- И представляете, он не ошибся, болят как самые настоящие.	- A propósito, hace unos días me pusieron dos dientes nuevos. El médico me aseguró que serían como los verdaderos.<br>- Y fijaos que no se equivocó, me duelen como los más auténticos.
- А вот я однажды спросил знакомого врача: "Это правда, если я буду есть много морковки, то буду лучше видеть?<br>- Я, кажется, знаю, что тебе обветил врач: "А где вы видели кроликов в очках?"	- Pues yo una vez le pregunté a un médico conocido: "¿Es verdad que si como muchas zanahorias, voy a ve mejor?"<br>- Me parece que sé lo que te respondió el médico: "¿Dónde ha visto Vd. conejos con gafas?"
- Давайте я расскажу вам анекдот, который никто из вас, наверняка, не слышал:<br>"Одна дама у входа в кинотеатр дала деньги бедному слепому.	- Ahora os cuento you un chiste que posiblemente ninguno de vosotros ha oído:<br>"Una señora dio dinero a un pobre ciego a la entrada del cine".
И каково же было её удивление, когда в зале рядом с собой она увидела "слепого"!<br>Впрочем, "слепой" не расстерялся: "Простите, я првильно сел, этот автобус идёт на Курский вокзал?"	¡Qué grande fue su sorpresa cuando vio al "ciego" a su lado en la sala!<br>Por su parte, el "ciego" no se inmutó: "Perdone, ¿voy ("me he sentado") bien?, ¿este autobús va a la estación de Kursk?"
- А теперь, анекдот о ресторане. Вот самый последний. Во всяком случае, я ранше не слышал.	- Y ahora un chiste sobre un restaurante. Es el último. En todo caso, no lo había oído antes.
- Официант, - обратился клиент к официанту. У этой курицы одна нога короче другой!<br>- А вы что, с ней собираетесь танцевать?	- Camarero - se dirigió un cliente al camarero - este pollo tiene una pata más corta que la otra.<br>- ¿Y qué?, ¿quiere Vd. bailar con él?
Всё, друзья, вы меня насмешили. С утра я был расстроен, а сейчас всё хорошо. Пора идти работать. Всего хорошего!	Está bien, amigos, me habéis hecho reír. Desde la mañana he estado de mal humor pero ahora todo va bien. Es hora de ir a trabajar. ¡Que tengáis un buen día!
- Какая ночь сегодня! Просто удивительно, ну как спать в такую ночь!<br>- Давай ещё проидёмся. Ты согласен?	- ¡Qué noche la de hoy! Es simplemente sorprendente, pero ¿cómo dormir en una noche así?<br>- Demos una vuelta más. ¿Estás de acuerdo?
- Что за луна в Италии! Я нигде такой не видел.<br>- А я видел на юге Россий, когда путешествовал там в прошлом году.	- ¡Qué luna la de Italia! En ninguna parte he visto nada parecido.<br>- Pues yo la vi en el sur de Rusia, cuando viajé por allí el año pasado.
- Ты неохотно отвешаешь на мои вопросы, но я хочу спросить тебя, чем ты недоволен.<br>- Уверяю тебя, ты ошибаешься. Мне просто ужасно захотелось спать.	- Estás contestando a mis preguntas sin ganas, sin embargo quiero preguntarte de qué estás descontento.<br>- Te aseguro que te equivocas. Simplemente tengo un sueño terrible.
- У меня никогда не бывало такой прекрасной встречи. Я вас благодарю за всё.<br>- Ах боже мой, за что вы меня благорадите? Я сделал то, что долшен был сделать для вас уже давно.	- En mi vida he tenido un encuentro tan bonito. Se lo agradezco todo.<br>- Ah, Dios mío. ¿Por qué me das las gracias? Hice lo que tenía que haber hecho para Vds. ya hace tiempo.
- Проснись, уже утро. На улице пасмурно, но так тепло.<br>- Я знал, что нам сегодня повезёт с погодой. Давай быстро оденемся и в лес.	- Despiértate, ya es de día. Fuera hace un tiempo gris, pero cálido.<br>- Sabí que hoy tendríamos suerte con el tiempo. Vistámonos rápido y vamos al bosque.
- Нечего нет хуже расставания.<br>- Я тоже так думаю.	- Nada es peor que la separación.<br>- Yo pienso lo mismo.
- Я никогда не забуду, что вы для меня сделали!<br>- Ну что вы! Я сделал то, что должен был сделать.	- Nunca olvidaré lo que Vd. hizo por mí.<br>- ¡Pero qué dice! Hice lo que debía hacer.
- Я не прощаюсь с вами.<br>- И я говорю "до свидания".	- No le digo "adiós".<br>- Y yo le digo "hasta la vista".
- Пишите нам, не забывайте нас!<br>- Я вам напишу, как только вернусь домой.	- Escríbanos, ¡no nos olvide!<br>- Es escribiré en cuanto vuelva a casa.
- Поймите меня правильно. Мне грустно с вами растаться. Но что поделаешь, надо уезжать.<br>- Уезжайте, но я к вам обязательно приеду.	- Compréndame bien. Me da pena separarme de Vd., pero ¿qué vamos a hacer? Debo irme.<br>- Váyase Vd., pero iré a verlo sin falta.
- Я думаю, что всё уже кончилось.<br>- Да, как говорят, всё хорошо, что хорошо кончается.	- Creo que está todo acabado.<br>- Sí, como dicen, bien está lo que bien acaba.
- Вы в самом деле решили уехать?<br>- Очень жаль, но это так. Я была счастлива здесь и никогда не забуду ваш город.	- ¿En efecto ha decidido irse?<br>- Es una lástima, pero es cierto. He sido feliz aquí y no olvidaré nunca su ciudad.
- Почему вы говорите вполголоса? Дети ещё не спят.<br>- На работе я иногда кричу, так что дома хочется поговорить тихо.	- ¿Por qué habla Vd. en voz baja? Los niños no duermen aún.<br>- En el trabajo a veces grito, por eso en casa me gusta hablar bajo.
- Вы меня так испугали. Я едва жива от ужаса.<br>- Простите, это была маленкая шутка. Теперь я понимаю, что эта шутка не очень умна. Ещё раз извините меня.	- Me ha asustado mucho. Estoy medio muerta de miedo.<br>- Perdone, ha sido una pequeña broma. Ahora comprendo que no ha sido una broma muy inteligente. Le pido perdón otra vez.
- Он уверяет меня, что ничего не знал об этом странном случае.<br>- Боюсь, что это не так.	- Él me asegura que no sabía nada de ese extraño caso.<br>- Me temo que no sea cierto.
Все его тайны на лице написаны.	Todos sus secretos están escritos en su rostro.
Летом я перегитал "Идиота" Достоевского, а теперь увлекаюсь Чеховым. Мне нравятся его милые и добрые герои, но они так несчастливы.	El verano releí "El Idiota" de Dostoyevski, y ahora me deleito con Chejov. me gustan sus personajes amables y buenos, pero son infelices.
