ноль	cero
один'	uno
два	dos
три	tres
четыре	cuatro
пять	cinco
шесть	seis
семь	siete
восемь	ocho
'девять	nueve
'десять	diez
сто	cien
одиннадцать	once
двенадцать	doce
тринадцать	trece
четырнадцать	catorce
пятнадцать	quince
шестнадцать	dieciséis
семнадцать	diecisiete
восемнадцать	dieciocho
девятнадцать	diecinueve
'тысяча	mil
миллион'<br />миллиард'	millón<br>mil millones
двадцать, двести	veinte, doscientos
'тридцать,' триста	treinta, trescientos
'сорок, четыреста	cuarenta, cuatrocientos
пятьдесят', пятьсот'	cincuenta, quinientos
шестьдесят', шестьсот'	sesenta, seiscientos
'семьдесят, семьсот'	setenta, setecientos
'восемьдесят, восемьсот'	ochenta, ochocientos
девяносто, девятьсот'	noventa, novecientos
'город	ciudad
дом	house
квартира	apartment
'улица	calle
дорога	camino
аэропорт	aeropuerto
вокзал'	estación de tren
мост	puente
гости́ница	hotel
ресторан'	restaurante
животное	animal
собака	perro
кот/кошка	gato
'рыба	pez, pescado
'птица	pájaro
корова	vaca
свинья'	cerdo
мышь	ratón
'лошадь	caballo
крыло'	ala
'поезд	tren
самолёт	avión
машина	coche, máquina
грузовик'	camión
велосипед'	bicicleta
автобус	autobús
'лодка	barca
корабль'	barco
'шина	neumático
бензин'	gasolina
'двигатель<br>	motor
билет'	boleto
транспорт'	transporte
'ферма	granja
двор	patio
школа	escuela
'офис	oficina
'комната	habitación
университет'	universidad
клуб	club
бар	bar
парк	parque
'лагерь	campamento
магазин'	tienda
театр'	teatro
библиотека	biblioteca
больница	hospital
'церковь	iglesia
'рынок	mercado
страна'	país
'здание / строение	edificio
земля'	tierra / suelo
'космос	espacio, cosmos
банк	banco
'место	lugar
'шляпа	sombrero
'платье	vestido
костюм'	traje
'юбка	falda
рубашка	camisa
футболка	camiseta
'брюки	pantalones
'обувь	calzado
карман'	bolsillo
пальто'	abrigo
пятно'	mancha
одежда	ropa
'красный	rojo
зелёный	verde
'синий	azul (marino)
голубой	azul (celeste)
жёлтый	amarillo
коричневый	marrón
'розовый	rosado
оранжевый	anaranjado
чёрный	negro
белый	blanco
'серый	gris
цвет	color
работа	trabajo
занятие	empleo / ocupación
'люди	gente
сын	hijo
дочь	hija
мать	madre
отец'	padre
родители	padres
ребёнок ('дети)	niño (niños)
мужчина	hombre
'женщина	mujer
брат	hermano
сестра'	hermana
семья'	familia
'дедушка	abuelo
'бабушка	abuela
муж	marido
жена'	esposa
король' / королева	rey / reina
президент'	presidente
сосед' / соседка	vecino / vecina
'мальчик	niño / muchacho
'девочка	niña
'взрослый	adulto
друг / подруга	amigo / amiga
'жертва	víctima
игрок'	jugador
болельщик	fan
толпа'	muchedumbre
человек'	persona
учитель / учительница	maestro / maestra
студент' / судентка	estudiante
адвокат' / юрист'	abogado
врач	médico
пациент'	paciente
официант' / официантка	camarero / camarera
секретарь'	secretario
священник	cura
поли́ция, полицейский	policía, agente de policía
'армия	ejército
солдат'	soldado
художник / художница	artista
'автор	autor
'менеджер	director / manager
журналист' / журналистка	periodista
актёр / актриса	actor / actriz
'общество	sociedad
религия	religión
небеса' / рай	cielo / paraíso
ад	infierno
смерть	muerte
медицина	medicina
лекарство	fármaco
'деньги	dinero
'доллар	dólar
счёт	cuenta
брак	matrimonio
'свадьба	boda
команда	equipo
отношения	relación
'раса	raza
секс (акт)	sexo (acto)
пол	"sexo (género) [también ""suelo""]"
убийство	asesinato
тюрьма'	cárcel
технология	tecnología
энергия	energía
война'	guerra
мир	paz (también mundo)
нападение	ataque
'выборы	elecciones
журнал'	revista
газета	periódico
яд	veneno
пистолет'	pistola
ружьё	escopeta
оружие	arma
спорт	deporte
'гонки	carrera
зарядка	ejercicio (físico)
мяч	pelota
игра'	juego
приз / 'премия	premio
контракт'	contrato
наркотик	droga
знак	señal
'наука	ciencia
Бог	dios
'группа	grupo (también musical)
'песня	canción
инструмент'	instrumento, herramienta
'музыка	música
фильм	película
искусство	arte
напиток	bebida
'кофе	café
чай	té
вино'	vino
'пиво	cerveza
сок	zumo
вода'	agua
молоко'	leche
яйцо'	huevo
сыр	queso
хлеб	pan
суп	sopa
торт	pastel
'курица	pollo
свинина	carne de cerdo
говя́дина	carne de ternera
'яблоко	manzana
банан'	plátano
апельсин'	naranja
лимон'	limón
кукуруза	maíz
рис	arroz
'масло	aceite, mantequilla
'мясо	carne
'семя	semilla
нож	cuchillo
'ложка	cuchara
'вилка	tenedor (también enchufe)
тарелка	plato
'чашка	taza
'завтрак	desayuno
обед'	almuerzo
'ужин	cena
'сахар	azúcar
соль	sal
бутылка	botella
еда'	comida
стол	mesa
стул	silla
кровать'	cama
сон	sueño
окно'	ventana
дверь	puerta
'спальня	dormitorio
'кухня	cocina
ванная комната	cuarto de baño
карандаш'	lápiz
'ручка	bolígrafo
фотография	fotografía
'мыло	jabón
'книга	libro
страни́ца	página
ключ	llave
'краска	pintura
письмо'	carta
записка	nota
стена'	pared
бумага	papel
потолок'	techo
'крыша	tejado
бассейн'	piscina
замок' / 'замок	cerradura / castillo
телефон'	teléfono
сад	jardín
игла'	aguja
'сумка	bolso
коробка	caja
подарок	regalo
карточка	tarjeta
кольцо'	anillo
часы'	reloj
'лампа	lámpara
вентилятор	ventilador
мобильный телефон	teléfono móvil
сеть	red
компьютер	computadora
программа	programa
ноутбук'	(computadora) portátil
экран'	pantalla
'камера	cámara
телевизор	televisor
'радио	radio
голова'	cabeza
'шея	cuello
лицо'	cara
борода'	barba
'волосы	cabellos
глаза'	ojos
рот	boca
'губы	labios
нос	nariz
зуб	diente
'ухо / 'уши	oreja / orejas
слеза' / слёзы	lágrima / lágrimas
язык'	lengua
спина'	espalda
'палец	dedo
нога'	pierna
рука'	mano / brazo
ступня'	pie
плечо'	hombro
'сердце	corazón
кровь	sangre
мозг	cerebro
колено	rodilla
пот	sudor
болезнь'	enfermedad
кость	hueso
'голос	voz
'кожа	piel
'тело	cuerpo
'море	mar
океан'	océano
река'	río
гора'	montaña
дождь	lluvia
снег	nieve
'дерево	árbol, madera
'солнце	sol
луна' / 'месяц	luna
лес	bosque
'небо	cielo, firmamento
растение	planta
'ветер	viento
'почва	suelo (tierra), base
цветок' / цветы'	flor / flores
долина	valle
'корень	raíz
'озеро / озёра	lago / lagos
звезда' / звёзды	estrella / estrellas
трава'	hierba
лист, 'листья	hoja, hojas
'воздух	aire
песок'	arena
пляж	playa
волна'	ola
огонь'	fuego
лёд	hielo
'остров / острова'	isla / islas
уклон' / склон / наклон'	pendiente / ladera / inclinación
природа	naturaleza
стекло' / стёкла	vidrio / vidrios
металл'	metal
'пластик / пластмасса	plástico
'камень	piedra
алмаз'	diamante
'глина	arcilla
пыль	polvo
'золото	oro
медь	cobre
серебро'	plata
материал'	material
'лето	verano
весна'	primavera
зима'	invierno
'осень	otoño
время года	estación del año
'мера	medida, límite
размер'	medida, talla, dimensión
метр	metro
сантиметр'	centímetro
килограмм' / кило'	kilogramo / kilo
половина	mitad
круг	círculo
квадрат'	cuadrado
температура	temperatura
число'	número, fecha
вес	peso
край	borde
угол	esquina
'карта	mapa (también, carta = naipe)
'точка	punto
согласный	consonante
гласный	vocal
свет	luz
звук	sonido
шум	ruido
кусок' / кусочек	trozo, pedazo
боль	dolor
поврежде́ние / ране́ние	herida
отверстие / дыра́	agujero
'образ	imagen, forma / modo
картина	imagen, cuadro, dibujo
рису́нок	dibujo, patrón, diseño
существительное	sustantivo
глагол'	verbo
прилагательное	adjetivo
направление	dirección
год	año
месяц	mes
неделя	semana
день	día
час	hora
минута	minuto
секунда	segundo
'утро	mañana (parte del día)
'вечер	tarde (parte del día)
ночь	noche
'время	tiempo
'верхний	(parte, etc.) de arriba
'нижний	(parte, etc.) de abajo
дно	fondo
сторона'	lado
'север	norte
юг	sur
восток'	este
'запад	oeste
'прямо	recto
налево	a la izquierda
направо	a la derecha
передний	(parte, ...) de delante
оборот'	reverso
зад / тыл	parte de atrás
колесо' / колёса	rueda / ruedas
'длинный	largo
короткий	corto
высокий	alto
низкий	bajo
широкий	ancho
'узкий	estrecho
большой'	grande
'маленький	pequeño
'медленный	lento
'быстрый	rápido
горячий	caliente
'жаркий	caliente (hace calor)
холодный	frío
тёплый, тепло'	cálido
похладный	fresco
'новый	nuevo
'старый	viejo
молодой'	joven
хороший	bueno
плохой'	malo
'мокрый	mojado
сухой	seco
больной	enfermo
здоровый	sano
громкий	alto (sonido)
тихий	tranquilo, callado
счастливый	feliz
грустный	triste
красивый	hermoso
ужа́сный	horrible, espantoso
глухой	sordo
слепой	ciego
милый	amable
злой	malvado / enojado
богатый	rico
бедный	pobre
толстый	gordo, grueso
тонкий	delgado, fino
дорогой	caro, querido
дешёвый (дёшево)	barato
ровный	llano, liso
кривой	curvo, torcido
мужской	masculino
женский	femenino
тугой	tenso, ajustado
мягкий	suave, blando
твёрдый	duro
глубокий	profundo
мелкий	somero, poco profundo
чистый	limpio
грязный	sucio
сильный	fuerte
слабый	débil
мёртвый	muerto
живой	vivo
тяжёлый (тяжело')	pesado, duro (de soportar, ...)
лёгкий (легко')	ligero, liviano, fácil
тёмный (темно')	oscuro
светлый	claro, luminoso
известный	famoso, conocido
ядерный	nuclear
долгий	largo (tiempo)
краткий	corto (tiempo)
(по)работать	trabajar
играть / сыграть	jugar
(по)гулять	pasear
'бегать	correr (multidireccional)
(по)бежать', бегу', бежишь', бегут'	correr (unidireccional)
(по)вести', веду', ведёшь, ведут'<br>(вёл, вела', вело', вели')	conducir (un coche), guiar, llevar (unidireccional)<br>вести себя = comportarse
водить', вожу', 'водишь, 'водят	conducir (un coche), guiar, llevar (multidireccional)
(по)'ехать, 'еду, 'едешь, 'едут<br />(imp. поезжай', поезжайте)	ir (en vehículo, unidireccional)
'ездить, 'езжу, 'ездишь, 'ездят	(ir, en vehículo, multidireccional)
идти', иду', идёшь, идут' / пойти'<br>(шёл, шла', шло', шли')	ir (a pie, unidireccional)
ходить', хожу', 'ходишь, 'ходят	ir (a pie, multidireccional)
летать'	volar (multidireccional)
(по)лететь', лечу', летишь', летят'	volar (unidireccional)
(по)плыть, плыву', плывёшь, плывут'<br>(плыл, плыла', плыло, плыли)	nadar, navegar (unidireccional)
'плавать	nadar, navegar (multidireccional)
остана́вливаться / останови́ться, остановлю́сь, остано́вишься, остано́вятся	parar, detenerse
(по)думать	pensar
говорить' / сказать', скажу', 'скажешь, 'скажут	decir, hablar
(по)сле'довать	seguir
(съ)есть, ем, ешь, ест, едим', еди'те, едят'<br />(ел, ела, ело, ели)<br />(imp. ешь, ешьте)	comer
(вы)пить, пью, пьёшь, пьют<br />(imp. пей, пейте)	beber
убивать' / убить', убью', убьёшь, убьют'<br>(убей, убейте)	matar
умирать' / умереть', умру', умрёшь, умрут'<br>('умер, умерла', 'умерло, 'умерли)	morir
улыбаться / улыбнуться, улыбнусь', улыбнёшься, улыбнутся	sonreír
(за)смеяться, смеюсь', смеёшься, смеют'ся	reír
'плакать, 'плачу, 'плачешь, 'плачут	llorar
покупать' / купить', куплю', 'купишь, 'купят	comprar
испо́льзовaть + A / по́льзовaться + I	usar
'двигать(ся), двигаю/движу, двигаешь/движешь, двигают/движут<br />/<br />'двинуть(ся), двину, двинешь, двинут	mover(se)
(со)гнуть, гну, гнёшь, гнут	doblar, flexionar, curvar
давать', даю', даёшь, дают'<br>/<br>дать, дам, дашь, даст, дадим', дадите, дакут'	dar
(за)платить', плачу', 'платишь, 'платят	pagar
оставаться, остаюсь', остаёшься, остаются<br />/<br />остать'ся, останусь, останешься, останутся	quedarse
продавать / продать	vender
(по)смотреть', смотрю' смотрешь, смотрят	mirar
стрелять' / стрельнуть', стрельну', стрельнёшь, стрельнут'	disparar
позволять' / позво́лить	permitir
надевать', надеваю, надеваешь, надевают<br>/<br>надеть', надену, наденешь, наденут	ponerse (ropa, ...)
снимать'<br>/<br>снять, сниму', снимешь, снимут	quitar, bajar, quitarse (ropas, ...), sacar (una foto), alquilar (casa, ...)
поднимать / поднять, подниму', поднимешь, поднимут	levantar, elevar, subir (algo)
бить, бью, бьёшь, бьют<br>(бей, бейте)	pegar
ударять' / ударить	golpear
'прыгать	saltar, rebotar
(вы/об/на)учить', учу' 'учишь, 'учат	aprender, enseñar
'запах	"olor (""sentir el olor de"" = oler algo)"
вкус	"sabor (""sentir el sabor de"" = saborear)"
'пахнуть, 'пахну, 'пахнешь, 'пахнут	oler (emitir olor)
(по)'слушать	escuchar
(у)'слышать, 'слышу, 'слышишь, 'слышат	oír
касаться / коснуться, коснусь', коснёшься, косннутся	tocar, concerner (+ G)
'трогать / 'тронуть	tocar, emocionar
(по)висеть', вишу', висишь', висят'	estar colgado
'вешать / повесить, повешу, повесишь, повесят	colgar
(у)'видеть, 'вижу, 'видишь, 'видят	ver
целовать	besar
'чувствовать	sentir
(по)любить', люблю', 'любишь, 'любят	amar
ложиться, ложусь', ложишся, ложатся<br>/<br>лечь, 'лягу, 'ляжешь, 'лягут<br>(лёг, легла', легло', легли')<br>(ляг, лягте)	tumbarse, yacer, estar echado
сжигать', сжечь, сожгу', сожжёшь, сожгут'<br>(сжёг, сожгла', сожгло', сожгли')	quemar
(с)гореть', горю', горишь', горят'	arder
(по)'резать, 'режу, 'режешь, 'режут	cortar
танцевать'	bailar
(рас)'плавить, 'плавлю, 'плавишь, 'плавят	fundir (metal, ...)
('вы)копа́ть	cavar
взрыва́ть / взорва́ть, взорву', взорвёшь, взорвут'	hacer explotar (reflexivo: explotar)
(по)стоя́ть, стою', стоишь', стоят'	estar de pie
(по)сидет', сижу', сидишь', сидят'	estar sentado
сади́ться, сажу́сь, сади́шься, садя́тся<br>/<br>сесть, ся́ду, ся́дешь, ся́дут	sentarse
(по)спать, сплю, спишь, спят	dormir
(с)петь, пою', поёшь, поют'	cantar
просыпать'ся / проснуть'ся	despertarse
боро́ться, -ю́сь,-ешься, -ются	luchar
пройти', проехать, ... (мимо + G)	pasar (por delante de...)
(по)менять'	cambiar
смесь	mezcla
(по/о)стричь, стригу́,стрижёшь, стригу́т	recortar
верёвка	cuerda
(по)считать'	contar, considerar
(по)женить'(ся), женю', 'женишь, 'женят	casarse (con = на + P)
(по)моли́ться, -ю́сь,-ишься	rogar, rezar
застрева́ть / застря́|ть, -ну,-нешь	atascarse (застря́л = atascado, atorado)
заставля́ть / заста́в|ить, -лю,-ишь	bloquear / obligar, forzar (a hacer algo)
выи́грывать / вы́играть	ganar, vencer
получа́ть / пол|учи́ть, -учу́,-у́чишь	recibir, conseguir, obtener
(по)теря́ть	perder (un objeto)
прои́грывать / проигра́ть	perder
(по)меша́ть<br>(с)меша́ть	remover<br>mezclar
(вы́/по)мыть, мо́ю, мо́ешь	lavar
(вы́/по)чи́|стить, -щу,-стишь	limpiar
(при)гото́в|ить, -лю,-ишь	preparar, cocinar
открыва́ть / откр|ы́ть, -о́ю,-о́ешь	abrir
закрыва́ть / закр|ы́ть, -о́ю,-о́ешь	cerrar
(na)пи|са́ть, -шу́,-шешь	escribir
станови́ться, становлю́сь. стано́вишься<br>/<br>стать, ста́ну, ста́нешь	convertirs en, volverse (+ I)
(с)пря́|тать, -чу,-чешь	esconder
нахо|ди́ть, нахожу́, нахо́дишь <br>/<br>на|йти́, -йду́,-йдёшь<br>(pt -шёл,-шла́,-шло́)	encontrar
'тронут	emocionado
внитовка	fusil
(рас)та́ять	derretirse (nieve, mantequilla, ..)
(по)звони́ть	telefonear
(по)звать, зову́, зовёшь, зову́т	llamar
повора́чивать / поверн|у́ть, -у́,-ёшь	girar (cambiar de dirección)
(по/вы)стро́ить	construir
(вы́)раст|и́, -у́,-ёшь<br>(рос,росла́,росло́)	crecer
(по)тян|у́ть, -у́,-ешь	tirar de, jalar
(вы́)тащ|и́ть, -у́,-ишь	arrastrar (unidireccional)
таска́ть	arrastrar (multidireccional)
(на/про)корм|и́ть, -лю́,-ишь	alimentar
лов|и́ть, -лю́,-ишь / пойма́ть	atrapar, agarrar
броса́ть / бро́|сить, -шу,-сишь	lanzar, arrojar
(с)ломать'(ся)	romper(se)
быть +I/(при+L)	llevar puesto (ropa, ...)
подпи́сывать / подп|иса́ть, -ишу́,-и́шешь	firmar
па́дать / (у)па́сть, паду́, падёшь	caer
(по)вез|ти́, -у́,-ёшь<br>(вёз,-ла́,-ло́)	llevar (en vehículo, unidireccional)
во|зи́ть, -жу́,-зишь	llevar (en vehículo, multidireccional)
нес|ти́, -у́,-ёшь<br>(нёс,-ла́,-ло́)	llevar (a pie, unidireccional)
но|си́ть, -шу́,-сишь	llevar (a pie, multidireccional)
кача́ть	agitarse, mecerse, vibrar, bombear
нажима́ть / наж|а́ть, -му́,-мёшь	apretar
толка́ть / толкн|у́ть, -у́,-ёшь	empujar
вынима́ть / вы́н|уть, -у,-ешь	sacar
(по)ста́в|ить, -лю,-ишь	poner (posición vertical)
вставля́ть / вста́в|ить, -лю,-ишь	meter
кла|сть, -ду́,-дёшь<br>(-л,-ла,-ло)<br>/<br>пол|ожи́ть, -ожу́,-о́жишь	poner (posición horizontal)
бере́менная	embarazada
Я здесь. Иди сюда.<br>Она там. Иди туда.<br>Он дома. Иди домой.	Estoy aquí. Ven acá.<br>Estoy ahí. Ve allá.<br>Está en casa. Ve a casa.
Они внизу'. Идите вниз/'снизу.<br />Мы наверху'. Идите наверх'/'сверху.<br />Я 'сзади [позади']. Иди назад'/'сзади.<br />Она впереди'. Иди вперёд/'спереди.	Están debajo. Id abajo/desde abajo.<br>Estamos encima. Id arriba/desde arriba.<br>Estamos detrás. Ve atrás/desde atrás.<br>Ella está delante. Ve adelante/desde delante.
Он направо. Иди направо. Прийди справа.<div>Она налево. Иди налево. Прийди слева.</div><div>Ты сбоку/в стороне. Иди вбок/в сторону. Прийди сбоку/со стороны.</div>	"<span class=""Apple-tab-span"" style=""white-space: pre""> </span>Él está a la derecha. Ve a la derecha. Ven desde la derecha.<div>Ella está a la izquierda. Ve a la izquierda. Ven desde la izquierda.</div><div>Estás al lado. Ve al lado. Ven desde el lado.</div>"
<div>внутри' - внутрь - изнутри'</div><div>снаружи - наружу - снаружи</div><div>[= вне - вовне' - извне']</div>	dentro - hacia dentro - desde dentro<div>fuera - hacia afuera, desde fuera</div>
